qc_id,municdv,municipio,tot_2007,urb_2007,txurb_2007,rur_2007,cresc_2007,geocodigo,icon_url
"0","2906907",Caravelas,21068,11523,54.694323,9545,0.672052,"2906907",
"1","1100015",Alta Floresta d'Oeste,23783,13312,55.972754,10471,-1.550964,"1100015",
"2","4309605",Horizontina,18273,14210,77.765008,4063,0.45699,"4309605",
"3","3550803",São Sebastião da Grama,12471,8278,66.377997,4193,0.019489,"3550803",
"4","2301950",Barreira,18388,7188,39.090711,11200,1.107143,"2301950",
"5","3550902",São Simão,13107,12191,93.011368,916,-0.604209,"3550902",
"6","3157708",Santa Juliana,10534,8778,83.330169,1756,3.865167,"3157708",
"7","2907103",Carinhanha,28398,12308,43.34108,16090,0.579648,"2907103",
"8","2302008",Barro,20640,11989,58.08624,8651,0.445973,"2302008",
"9","2302057",Barroquinha,14779,9687,65.545707,5092,0.858071,"2302057",
"10","3157906",Santa Margarida,14165,6775,47.829156,7390,0.464358,"3157906",
"11","2907301",Castro Alves,24350,13977,57.400411,10373,-0.690972,"2907301",
"12","2302107",Baturité,31537,22848,72.448235,8689,0.783168,"2302107",
"13","1100056",Cerejeiras,16237,13585,83.666934,2652,-1.6226,"1100056",
"14","3158003",Santa Maria de Itabira,10377,6029,58.099643,4348,0.04275,"3158003",
"15","2302206",Beberibe,45962,19774,43.022497,26188,1.178488,"2302206",
"16","1100064",Colorado do Oeste,17535,12486,71.206159,5049,-3.120592,"1100064",
"17","2302305",Bela Cruz,29462,12232,41.517887,17230,0.547093,"2302305",
"18","2907509",Catu,48471,40139,82.81034,8332,0.523622,"2907509",
"19","3158201",Santa Maria do Suaçuí,14270,10232,71.702873,4038,-0.079833,"3158201",
"20","1100080",Costa Marques,13487,7119,52.784163,6368,4.059587,"1100080",
"21","4310009",Ibirubá,18604,14329,77.021071,4275,-0.022249,"4310009",
"22","2907608",Central,17284,7965,46.083083,9319,0.413404,"2907608",
"23","2302503",Brejo Santo,39589,24330,61.456465,15259,0.405229,"2302503",
"24","1100098",Espigão d'Oeste,27753,19301,69.545635,8452,1.110694,"1100098",
"25","4310108",Igrejinha,30930,29678,95.95215,1252,2.086568,"4310108",
"26","3551603",Serra Negra,24555,21239,86.495622,3316,0.416427,"3551603",
"27","2907707",Chorrochó,10502,2441,23.243192,8061,0.458551,"2907707",
"28","1100106",Guajará-Mirim,35829,32876,91.758073,2953,-0.853651,"1100106",
"29","2302701",Campos Sales,25501,18276,71.667778,7225,-0.03636,"2302701",
"30","2907806",Cícero Dantas,30761,16851,54.780404,13910,-0.080086,"2907806",
"31","3551801",Sete Barras,12835,6357,49.528633,6478,-0.941842,"3551801",
"32","2907905",Cipó,15025,10184,67.780366,4841,0.724115,"2907905",
"33","4310330",Imbé,14868,14826,99.717514,42,2.815163,"4310330",
"34","3551900",Severínia,14636,13880,94.834654,756,1.048991,"3551900",
"35","2908002",Coaraci,22682,20516,90.450578,2166,-2.890726,"2908002",
"36","2302909",Capistrano,16341,5773,35.328315,10568,0.454895,"2302909",
"37","1100130",Machadinho d'Oeste,31183,16134,51.73973,15049,4.614615,"1100130",
"38","2908101",Cocos,17295,7612,44.01272,9683,-0.258327,"2908101",
"39","2303006",Caridade,17927,9629,53.712278,8298,2.002365,"2303006",
"40","1100148",Nova Brasilândia d'Oeste,16942,7906,46.665093,9036,-0.10496,"1100148",
"41","3552106",Socorro,32948,21684,65.812796,11264,0.106244,"3552106",
"42","2303105",Cariré,18464,7779,42.130633,10685,-0.11782,"2303105",
"43","2908200",Conceição da Feira,19005,12036,63.330702,6969,1.174003,"2908200",
"44","1100155",Ouro Preto do Oeste,35832,25794,71.985934,10038,-1.866608,"1100155",
"45","2303204",Caririaçu,26265,11775,44.831525,14490,0.292757,"2303204",
"46","2908309",Conceição do Almeida,17598,8243,46.84055,9355,-1.023461,"2908309",
"47","1100189",Pimenta Bueno,32408,27560,85.040731,4848,0.292564,"1100189",
"48","2303303",Cariús,18614,7659,41.146449,10955,0.131156,"2303303",
"49","2303402",Carnaubal,15982,7598,47.540984,8384,0.690889,"2303402",
"50","1100254",Presidente Médici,22087,12877,58.301263,9210,-2.497542,"1100254",
"51","2908606",Conde,21689,11349,52.326064,10340,0.860778,"2908606",
"52","2908705",Condeúba,16984,7277,42.846208,9707,-0.863504,"2908705",
"53","2303600",Catarina,16995,8581,50.491321,8414,1.280291,"2303600",
"54","1100288",Rolim de Moura,48439,38655,79.8014,9784,0.315681,"1100288",
"55","3552601",Tabapuã,11168,10187,91.215974,981,0.894609,"3552601",
"56","2303659",Catunda,10493,5128,48.870676,5365,1.761048,"2303659",
"57","3552700",Tabatinga,13904,11612,83.515535,2292,0.976115,"3552700",
"58","2908903",Coração de Maria,23068,8477,36.747876,14591,-0.456032,"2908903",
"59","4310603",Itaqui,36196,31687,87.542822,4509,-1.336196,"4310603",
"60","2303808",Cedro,24580,14456,58.812042,10124,0.304739,"2303808",
"61","1100320",São Miguel do Guaporé,22524,7315,32.47647,15209,-0.828104,"1100320",
"62","3159605",Santa Rita do Sapucaí,33990,28807,84.751397,5183,1.201433,"3159605",
"63","2909109",Coribe,14481,5575,38.498722,8906,-0.641236,"2909109",
"64","2303907",Chaval,12071,8681,71.916163,3390,-0.108408,"2303907",
"65","1100338",Nova Mamoré,20943,11994,57.269732,8949,5.10706,"1100338",
"66","2303931",Choró,12714,3494,27.481516,9220,0.827891,"2303931",
"67","2909208",Coronel João Sá,18037,6649,36.863115,11388,-1.226914,"2909208",
"68","1100346",Alvorada d'Oeste,16341,8272,50.621137,8069,-2.72809,"1100346",
"69","3159803",Santa Vitória,15104,12372,81.912076,2732,-1.138968,"3159803",
"70","2909307",Correntina,31440,12327,39.208015,19113,0.39559,"2909307",
"71","2303956",Chorozinho,18208,10592,58.172232,7616,-0.385494,"2303956",
"72","1100379",Alto Alegre dos Parecis,11580,3392,29.291883,8188,-1.319112,"1100379",
"73","3159902",Santo Antônio do Amparo,17062,15081,88.389403,1981,0.824461,"3159902",
"74","2909406",Cotegipe,13515,6335,46.873844,7180,0.149936,"2909406",
"75","2304004",Coreaú,21109,12087,57.259937,9022,0.787624,"2304004",
"76","1100403",Alto Paraíso,16654,7577,45.496577,9077,3.468291,"1100403",
"77","3553302",Tambaú,21795,19170,87.955953,2625,-0.299848,"3553302",
"78","1100452",Buritis,32669,17983,55.046068,14686,3.505494,"1100452",
"79","4311007",Jaguarão,27751,25421,91.603906,2330,-1.150766,"4311007",
"80","3553401",Tanabi,23271,20075,86.266168,3196,0.427101,"3553401",
"81","2909604",Crisópolis,19475,7712,39.599487,11763,0.325488,"2909604",
"82","4311106",Jaguari,11516,6321,54.88885,5195,-1.150909,"4311106",
"83","2909703",Cristópolis,13562,3044,22.445067,10518,0.985775,"2909703",
"84","2304236",Croatá,17302,7063,40.82187,10239,1.066235,"2304236",
"85","3553609",Tapiratiba,12199,9918,81.301746,2281,-0.84107,"3553609",
"86","2304251",Cruz,22098,9513,43.049145,12585,1.596413,"2304251",
"87","3160306",Santo Antônio do Jacinto,11280,6218,55.124113,5062,-1.048804,"3160306",
"88","1100700",Campo Novo de Rondônia,12367,3101,25.074796,9266,1.090289,"1100700",
"89","3160405",Santo Antônio do Monte,24660,20877,84.659367,3783,0.707227,"3160405",
"90","2909901",Curaçá,32354,13007,40.202139,19347,1.65555,"2909901",
"91","1100809",Candeias do Jamari,16409,9733,59.31501,6676,3.261833,"1100809",
"92","2910008",Dário Meira,12507,4967,39.71376,7540,-2.76746,"2910008",
"93","4311205",Júlio de Castilhos,19369,16029,82.75595,3340,-0.749251,"4311205",
"94","3553807",Taquarituba,22105,19141,86.591269,2964,0.079745,"3553807",
"95","2910107",Dom Basílio,11084,1716,15.481776,9368,0.876736,"2910107",
"96","2304301",Farias Brito,19221,8082,42.04776,11139,-0.787683,"2304301",
"97","1100940",Cujubim,13288,9371,70.522276,3917,10.66775,"1100940",
"98","3160702",Santos Dumont,45768,39812,86.986541,5956,-0.314689,"3160702",
"99","2304350",Forquilha,20148,13535,67.177884,6613,2.043311,"2304350",
"100","1101005",Governador Jorge Teixeira,11389,2506,22.003688,8883,-2.544663,"1101005",
"101","4311304",Lagoa Vermelha,27209,23438,86.140615,3771,-1.306636,"4311304",
"102","3553955",Tarumã,12270,11449,93.308883,821,1.916751,"3553955",
"103","2910404",Encruzilhada,22196,4845,21.828257,17351,-5.477011,"2910404",
"104","2304459",Fortim,14045,9568,68.123888,4477,2.193349,"2304459",
"105","1101203",Ministro Andreazza,10308,3245,31.480404,7063,-1.356323,"1101203",
"106","2304509",Frecheirinha,12780,7056,55.211268,5724,1.107137,"2304509",
"107","2910503",Entre Rios,38512,23966,62.229954,14546,0.376168,"2910503",
"108","1101302",Mirante da Serra,12062,6299,52.221854,5763,-1.230451,"1101302",
"109","3161007",São Domingos do Prata,17288,10119,58.53193,7169,-0.28915,"3161007",
"110","2910602",Esplanada,30947,19718,63.715384,11229,1.844763,"2910602",
"111","1101401",Monte Negro,12172,5940,48.800526,6232,-0.522902,"1101401",
"112","3554300",Teodoro Sampaio,20197,15782,78.140318,4415,0.137978,"3554300",
"113","2304657",Graça,15275,5691,37.256956,9584,0.439711,"2304657",
"114","3554508",Tietê,33875,31020,91.571956,2855,0.947968,"3554508",
"115","2910750",Fátima,18888,6771,35.848158,12117,0.454387,"2910750",
"116","2304954",Guaiúba,22382,17440,77.919757,4942,1.704967,"2304954",
"117","2305001",Guaraciaba do Norte,36647,17225,47.002483,19422,0.643877,"2305001",
"118","2910859",Filadélfia,15928,8417,52.844048,7511,-1.086652,"2910859",
"119","1101492",São Francisco do Guaporé,15490,8040,51.904454,7450,4.896111,"1101492",
"120","1101500",Seringueiras,11593,3803,32.804278,7790,-0.076168,"1101500",
"121","2305209",Hidrolândia,18474,10458,56.609289,8016,0.623858,"2305209",
"122","2911006",Floresta Azul,10283,7308,71.068754,2975,-1.723815,"2911006",
"123","2911105",Formosa do Rio Preto,20658,11364,55.010166,9294,1.756063,"2911105",
"124","2305233",Horizonte,48568,42379,87.257042,6189,5.319518,"2305233",
"125","4311809",Marau,33720,28678,85.04745,5042,2.503337,"4311809",
"126","3161809",São Gonçalo do Pará,10253,7798,76.055789,2455,3.665752,"3161809",
"127","2911204",Gandu,29838,24238,81.231986,5600,1.352456,"2911204",
"128","2305266",Ibaretama,12673,4171,32.912491,8502,0.126894,"2305266",
"129","1101708",Urupá,13362,4846,36.267026,8516,-1.525434,"1101708",
"130","2305308",Ibiapina,23073,9685,41.975469,13388,0.580387,"2305308",
"131","3555109",Tupi Paulista,12661,10711,84.598373,1950,-0.685986,"3555109",
"132","3162005",São Gonçalo do Sapucaí,22626,18501,81.768762,4125,0.202409,"3162005",
"133","2911303",Gentio do Ouro,11267,5602,49.720422,5665,1.469854,"2911303",
"134","2305332",Ibicuitinga,10975,5588,50.915718,5387,2.183406,"2305332",
"135","3162104",São Gotardo,30527,28623,93.762898,1904,1.434089,"3162104",
"136","2911402",Glória,13863,2691,19.411383,11172,-0.697356,"2911402",
"137","2305357",Icapuí,17720,5515,31.123025,12205,1.422313,"2305357",
"138","1200013",Acrelândia,11468,5445,47.479944,6023,5.401958,"1200013",
"139","2911600",Governador Mangabeira,19732,7271,36.848774,12461,2.010942,"2911600",
"140","1200104",Brasiléia,18992,12175,64.105939,6817,1.584422,"1200104",
"141","2305605",Independência,25349,10788,42.557892,14561,0.049126,"2305605",
"142","3162401",São João da Ponte,26007,8303,31.92602,17704,-0.01153,"3162401",
"143","2305654",Ipaporanga,11346,3589,31.632293,7757,0.125276,"2305654",
"144","3162450",São João das Missões,10742,2119,19.726308,8623,0.700107,"3162450",
"145","2911808",Guaratinga,22339,10172,45.534715,12167,-1.205869,"2911808",
"146","2305704",Ipaumirim,11510,6607,57.402259,4903,-0.035942,"2305704",
"147","2305803",Ipu,39352,23425,59.526835,15927,0.099866,"2305803",
"148","2911857",Heliópolis,13998,5751,41.084441,8247,0.942871,"2911857",
"149","1200252",Epitaciolândia,13392,9191,68.630526,4201,2.813421,"1200252",
"150","2305902",Ipueiras,37996,18211,47.928729,19785,-0.083563,"2305902",
"151","2911907",Iaçu,27682,21141,76.370927,6541,-0.415659,"2911907",
"152","1200302",Feijó,31048,15496,49.909817,15552,2.16667,"1200302",
"153","2306009",Iracema,14242,9930,69.723353,4312,1.140648,"2306009",
"154","3556008",Urupês,11858,10449,88.117726,1409,0.030155,"3556008",
"155","2306108",Irauçuba,21881,13353,61.025547,8528,1.614785,"2306108",
"156","2912103",Ibicaraí,24597,18310,74.439972,6287,-2.257929,"2912103",
"157","1200336",Mâncio Lima,13718,8133,59.287068,5585,3.078055,"1200336",
"158","2912202",Ibicoara,15774,5824,36.921516,9950,1.257281,"2912202",
"159","3162708",São João do Paraíso,21821,9609,44.035562,12212,0.542528,"3162708",
"160","2912301",Ibicuí,15618,11558,74.004354,4060,0.455472,"2912301",
"161","1200351",Marechal Thaumaturgo,12999,3176,24.432649,9823,6.627814,"1200351",
"162","3556305",Valparaíso,18681,17268,92.436165,1413,0.082094,"3556305",
"163","3162807",São João Evangelista,15620,9837,62.976953,5783,0.086267,"3162807",
"164","2912400",Ibipeba,16725,9897,59.174888,6828,1.221799,"2912400",
"165","2306306",Itapagé,45363,31901,70.323832,13462,1.422291,"2306306",
"166","1200385",Plácido de Castro,17164,8809,51.322536,8355,1.777943,"1200385",
"167","3162906",São João Nepomuceno,24875,23480,94.39196,1395,0.641565,"3162906",
"168","2912509",Ibipitanga,13824,4281,30.967882,9543,0.425683,"2912509",
"169","3556404",Vargem Grande do Sul,37212,34824,93.582715,2388,0.354318,"3556404",
"170","2306504",Itapiúna,17501,8380,47.882978,9121,1.042055,"2306504",
"171","2306553",Itarema,34069,13860,40.682145,20209,1.66645,"2306553",
"172","2912707",Ibirapitanga,22929,6053,26.398884,16876,0.477519,"2912707",
"173","1200427",Rodrigues Alves,12358,3667,29.673086,8691,6.233787,"1200427",
"174","4312500",Mostardas,11852,7838,66.132298,4014,0.236049,"4312500",
"175","2306603",Itatira,17647,7802,44.211481,9845,1.832067,"2306603",
"176","2912905",Ibirataia,23556,17686,75.080659,5870,-0.698708,"2912905",
"177","2306702",Jaguaretama,17811,8187,45.965976,9624,-0.169684,"2306702",
"178","1200450",Senador Guiomard,18814,11246,59.774636,7568,-0.699102,"1200450",
"179","2913002",Ibitiara,15780,3175,20.120406,12605,1.272795,"2913002",
"180","1200500",Sena Madureira,34007,21206,62.35775,12801,2.091452,"1200500",
"181","3556800",Viradouro,16986,16360,96.314612,626,0.892222,"3556800",
"182","2913101",Ibititá,18559,8452,45.541247,10107,0.513813,"2913101",
"183","2306900",Jaguaribe,35123,22381,63.721778,12742,0.024835,"2306900",
"184","1200609",Tarauacá,31985,16472,51.49914,15513,2.982886,"1200609",
"185","4312658",Não-Me-Toque,15143,13020,85.980321,2123,0.708323,"4312658",
"186","2913200",Ibotirama,25156,18620,74.018127,6536,0.585327,"2913200",
"187","2307007",Jaguaruana,30888,17995,58.258871,12893,0.54495,"2307007",
"188","1200708",Xapuri,14259,7328,51.392103,6931,2.548432,"1200708",
"189","2307106",Jardim,25829,7895,30.566418,17934,-0.319436,"2307106",
"190","1200807",Porto Acre,13640,1834,13.445748,11806,2.572761,"1200807",
"191","4312708",Nonoai,12247,8973,73.266923,3274,-0.653306,"4312708",
"192","2913408",Igaporã,14483,7378,50.942484,7105,-0.07278,"2913408",
"193","1300029",Alvarães,12985,6964,53.631113,6021,0.954032,"1300029",
"194","2307254",Jijoca de Jericoacoara,15246,4598,30.15873,10648,3.370133,"2307254",
"195","2913457",Igrapiúna,13205,3887,29.43582,9318,-1.76684,"2913457",
"196","3163706",São Lourenço,40117,40117,100,0,1.190707,"3163706",
"197","2913507",Iguaí,27658,14056,50.820739,13602,1.376437,"2913507",
"198","3557204",Chavantes,12170,10931,89.819228,1239,-0.028141,"3557204",
"199","2307403",Jucás,22872,12490,54.608255,10382,0.150808,"2307403",
"200","1300102",Anori,13748,8587,62.459994,5161,2.814923,"1300102",
"201","2307502",Lavras da Mangabeira,29834,16924,56.727224,12910,-0.638887,"2307502",
"202","2913705",Inhambupe,34305,14091,41.075645,20214,2.135167,"2913705",
"203","1300144",Apuí,17176,9224,53.702841,7952,3.107557,"1300144",
"204","2913804",Ipecaetá,15985,2330,14.576165,13655,-1.97699,"2913804",
"205","1300201",Atalaia do Norte,13618,5733,42.098693,7885,4.437336,"1300201",
"206","2913903",Ipiaú,42128,37542,89.114128,4586,-0.49628,"2913903",
"207","2307635",Madalena,16951,6199,36.570114,10752,1.894648,"2307635",
"208","1300300",Autazes,29635,12405,41.859288,17230,2.848819,"1300300",
"209","1300409",Barcelos,24113,6655,27.59922,17458,-0.049667,"1300409",
"210","4313060",Nova Hartz,16665,14020,84.128413,2645,1.446626,"4313060",
"211","1300508",Barreirinha,26546,11728,44.179914,14818,2.339209,"1300508",
"212","2307809",Marco,23081,14026,60.768598,9055,1.760346,"2307809",
"213","1300607",Benjamin Constant,28889,18255,63.190142,10634,3.170508,"1300607",
"214","2914307",Iramaia,15063,7553,50.142734,7510,-2.16177,"2914307",
"215","2307908",Martinópole,10289,7953,77.296142,2336,2.5913,"2307908",
"216","1300631",Beruri,13764,7768,56.437082,5996,3.203272,"1300631",
"217","4313201",Nova Petrópolis,17626,12736,72.256893,4890,0.610343,"4313201",
"218","2914406",Iraquara,22512,5598,24.866738,16914,2.97616,"2914406",
"219","2308005",Massapê,33152,22578,68.104488,10574,1.644917,"2308005",
"220","1300680",Boa Vista do Ramos,13032,6566,50.383671,6466,3.159579,"1300680",
"221","4313300",Nova Prata,22106,18053,81.665611,4053,2.700778,"4313300",
"222","3164506",São Sebastião do Maranhão,11667,3396,29.10774,8271,0.07738,"3164506",
"223","2308104",Mauriti,41579,21228,51.054619,20351,-0.278605,"2308104",
"224","2914505",Irará,24936,9001,36.096407,15935,-0.129375,"2914505",
"225","1300706",Boca do Acre,29558,17828,60.315312,11730,1.323499,"1300706",
"226","2308203",Meruoca,12068,6443,53.389128,5625,0.894105,"2308203",
"227","1300805",Borba,30884,14003,45.340629,16881,1.094047,"1300805",
"228","2914653",Itabela,24863,19251,77.428307,5612,-0.49731,"2914653",
"229","2308302",Milagres,27249,11439,41.979522,15810,0.152969,"2308302",
"230","1300839",Caapiranga,10540,4613,43.766603,5927,2.606021,"1300839",
"231","2308351",Milhã,14103,6555,46.479472,7548,1.139105,"2308351",
"232","1300904",Canutama,11430,5804,50.778653,5626,0.897515,"1300904",
"233","2308377",Miraíma,12123,6200,51.142456,5923,0.860841,"2308377",
"234","1301001",Carauari,24820,18154,73.142627,6666,0.832254,"1301001",
"235","3165008",São Tiago,10234,7961,77.789721,2273,-0.015346,"3165008",
"236","2914901",Itacaré,24519,14165,57.771524,10354,4.415148,"2914901",
"237","2308401",Missão Velha,33654,14603,43.391573,19051,0.461765,"2308401",
"238","1301100",Careiro,30792,6697,21.749156,24095,1.599909,"1301100",
"239","2915007",Itaeté,13780,5593,40.587808,8187,-0.232124,"2915007",
"240","2308500",Mombaça,44292,18657,42.122731,25635,1.033905,"2308500",
"241","1301159",Careiro da Várzea,22925,789,3.441658,22136,4.132102,"1301159",
"242","2308609",Monsenhor Tabosa,16537,8761,52.97817,7776,0.167847,"2308609",
"243","2915106",Itagi,13851,10114,73.019999,3737,-0.777652,"2915106",
"244","2915205",Itagibá,16108,9443,58.623044,6665,-0.925264,"2915205",
"245","1301308",Codajás,15929,11486,72.107477,4443,-1.340357,"1301308",
"246","4313508",Osório,38378,33749,87.938402,4629,0.865627,"4313508",
"247","1301407",Eirunepé,29266,20608,70.416183,8658,1.66351,"1301407",
"248","2915353",Itaguaçu da Bahia,12388,2354,19.00226,10034,1.310359,"2915353",
"249","2308906",Morrinhos,21065,8866,42.088773,12199,2.330296,"2308906",
"250","1301506",Envira,16350,9683,59.223242,6667,-2.167088,"1301506",
"251","4313656",Palmares do Sul,11387,9882,86.783174,1505,0.687189,"4313656",
"252","2309003",Mucambo,13985,8470,60.564891,5515,0.179016,"2309003",
"253","1301605",Fonte Boa,19609,12784,65.194554,6825,-6.551055,"1301605",
"254","4313706",Palmeira das Missões,33553,28332,84.439543,5221,-1.83299,"4313706",
"255","3165552",Setubinha,10813,2465,22.796634,8348,2.190839,"3165552",
"256","2915502",Itajuípe,20279,15700,77.419991,4579,-1.480618,"2915502",
"257","2309102",Mulungu,10956,4064,37.09383,6892,3.018564,"2309102",
"258","1301654",Guajará,14088,6541,46.429585,7547,0.912604,"1301654",
"259","2309201",Nova Olinda,12939,7723,59.687766,5216,0.989769,"2309201",
"260","1301704",Humaitá,38162,27748,72.711074,10414,2.188368,"1301704",
"261","4313904",Panambi,36233,32557,89.854552,3676,1.516401,"4313904",
"262","2309300",Nova Russas,30587,22169,72.478504,8418,0.592962,"2309300",
"263","1301803",Ipixuna,17037,7197,42.243353,9840,2.071658,"1301803",
"264","2309409",Novo Oriente,27385,13732,50.14424,13653,0.678468,"2309409",
"265","2915809",Itambé,32497,22127,68.089362,10370,0.745782,"2915809",
"266","1301852",Iranduba,32378,11898,36.747174,20480,0.033135,"1301852",
"267","2309458",Ocara,23242,7101,30.552448,16141,1.062876,"2309458",
"268","2916005",Itanhém,20607,14066,68.258359,6541,-0.494079,"2916005",
"269","2309508",Orós,21222,15525,73.155216,5697,-0.527873,"2309508",
"270","4314050",Parobé,48556,46029,94.7957,2527,1.164521,"4314050",
"271","2916203",Itapé,11116,6700,60.27348,4416,-3.856575,"2916203",
"272","2916302",Itapebi,11473,9527,83.038438,1946,0.439703,"2916302",
"273","2309805",Pacoti,11078,4474,40.386351,6604,0.193635,"2309805",
"274","3166204",Senhora dos Remédios,10189,3451,33.86986,6738,0.233508,"3166204",
"275","1302306",Jutaí,16878,9645,57.145396,7233,-4.024002,"1302306",
"276","2916500",Itapicuru,30547,6013,19.684421,24534,1.610408,"2916500",
"277","1302405",Lábrea,36235,21843,60.281496,14392,3.25541,"1302405",
"278","2310100",Palmácia,10288,4489,43.633359,5799,0.610332,"2310100",
"279","2310209",Paracuru,30527,19607,64.228388,10920,1.481376,"2310209",
"280","1302553",Manaquiri,18991,5085,26.775841,13906,5.903358,"1302553",
"281","2916807",Itarantim,17541,14347,81.791232,3194,0.513706,"2916807",
"282","2310258",Paraipaba,28101,13169,46.863101,14932,1.4188,"2310258",
"283","2310308",Parambu,30515,12849,42.10716,17666,-0.809715,"2310308",
"284","2916856",Itatim,14510,9611,66.237078,4899,1.921602,"2916856",
"285","1302702",Manicoré,43916,19465,44.323253,24451,2.073972,"1302702",
"286","3166808",Serra do Salitre,10154,7462,73.48828,2692,1.12373,"3166808",
"287","2916906",Itiruçu,15653,11570,73.915543,4083,2.04486,"2916906",
"288","2310407",Paramoti,11551,5140,44.498312,6411,0.739978,"2310407",
"289","1302801",Maraã,17450,7043,40.361032,10407,0.307472,"1302801",
"290","2917003",Itiúba,35594,9448,26.5438,26146,0.020486,"2917003",
"291","2310506",Pedra Branca,40703,20688,50.82672,20015,-0.013681,"2310506",
"292","1302900",Maués,46694,23796,50.96158,22898,2.221993,"1302900",
"293","2917102",Itororó,19985,17758,88.856642,2227,0.133669,"2917102",
"294","1303007",Nhamundá,17437,7180,41.176808,10257,1.833073,"1303007",
"295","2917201",Ituaçu,17916,5828,32.529582,12088,0.52766,"2917201",
"296","2310704",Pentecoste,33665,20339,60.415862,13326,0.460291,"2310704",
"297","1303106",Nova Olinda do Norte,28969,13103,45.231109,15866,2.893896,"1303106",
"298","4314506",Pinheiro Machado,12927,9634,74.526186,3293,-1.717822,"4314506",
"299","3167103",Serro,20746,12304,59.307818,8442,-0.181838,"3167103",
"300","2917300",Ituberá,23452,16773,71.520553,6679,-0.408085,"2917300",
"301","2310803",Pereiro,15054,5450,36.203003,9604,-0.161228,"2310803",
"302","1303205",Novo Airão,14496,10674,73.634106,3822,5.983781,"1303205",
"303","2917334",Iuiú,11440,5110,44.667832,6330,1.247559,"2917334",
"304","2310852",Pindoretama,17086,10341,60.523235,6745,1.925172,"2310852",
"305","1303304",Novo Aripuanã,17903,10760,60.101659,7143,0.641755,"1303304",
"306","4314605",Piratini,20210,11703,57.906977,8507,0.575695,"4314605",
"307","2310902",Piquet Carneiro,14712,6459,43.902936,8253,1.637369,"2310902",
"308","4314704",Planalto,10577,5597,52.916706,4980,-0.942641,"4314704",
"309","2917409",Jacaraci,14308,4659,32.562203,9649,0.812551,"2917409",
"310","1303502",Pauini,18152,8959,49.355443,9193,0.86328,"1303502",
"311","2311009",Poranga,11791,7698,65.287083,4093,0.065597,"2311009",
"312","1303536",Presidente Figueiredo,23077,11095,48.078173,11982,4.121396,"1303536",
"313","2917607",Jaguaquara,46529,36494,78.432805,10035,-0.028215,"2917607",
"314","2311108",Porteiras,14775,5090,34.450085,9685,-0.825792,"2311108",
"315","1303569",Rio Preto da Eva,24403,12402,50.82162,12001,4.79469,"1303569",
"316","2917706",Jaguarari,29023,14893,51.314475,14130,0.819162,"2917706",
"317","1303601",Santa Isabel do Rio Negro,16746,6242,37.274573,10504,6.807282,"1303601",
"318","2917805",Jaguaripe,16101,5319,33.035215,10782,2.633893,"2917805",
"319","1303700",Santo Antônio do Içá,29118,11642,39.982142,17476,0.452071,"1303700",
"320","3168002",Taiobeiras,29625,23892,80.648101,5733,1.149583,"3168002",
"321","2311264",Quiterianópolis,20044,5935,29.609858,14109,1.265481,"2311264",
"322","1303809",São Gabriel da Cachoeira,38576,16656,43.177105,21920,3.683375,"1303809",
"323","1303908",São Paulo de Olivença,30609,12605,41.180698,18004,4.094443,"1303908",
"324","2311355",Quixelô,15678,4695,29.946422,10983,0.074942,"2311355",
"325","2918100",Jeremoabo,37199,16701,44.896368,20498,0.908916,"2918100",
"326","2918209",Jiquiriçá,13310,5182,38.933133,8128,-0.347173,"2918209",
"327","4315107",Porto Xavier,10803,5384,49.838008,5419,-0.501547,"4315107",
"328","2918308",Jitaúna,16689,9051,54.233327,7638,-3.265987,"2918308",
"329","2311504",Quixeré,18612,11092,59.59596,7520,1.420624,"2311504",
"330","1304062",Tabatinga,44946,30664,68.224091,14282,2.45844,"1304062",
"331","4100509",Altônia,19724,14001,70.984587,5723,0.363009,"4100509",
"332","3168408",Tarumirim,14103,7697,54.57704,6406,-0.38402,"3168408",
"333","2918357",João Dourado,20767,12883,62.035922,7884,1.303632,"2918357",
"334","2311603",Redenção,25647,14741,57.476508,10906,0.369693,"2311603",
"335","1304104",Tapauá,19250,9897,51.412987,9353,-0.960179,"1304104",
"336","4100608",Alto Paraná,12906,10538,81.651945,2368,0.210974,"4100608",
"337","3168507",Teixeiras,11585,7483,64.592145,4102,0.549524,"3168507",
"338","2311702",Reriutaba,19270,9822,50.97042,9448,-1.370284,"2311702",
"339","4100707",Alto Piquiri,10060,8368,83.180915,1692,-0.957689,"4100707",
"340","2918456",Jucuruçu,10527,1854,17.611855,8673,-2.286267,"2918456",
"341","1304237",Tonantins,19049,6257,32.846869,12792,2.97777,"1304237",
"342","2918506",Jussara,14820,9444,63.724696,5376,-0.490521,"2918506",
"343","2311900",Saboeiro,16225,8325,51.309707,7900,-0.00088,"2311900",
"344","2311959",Salitre,15784,5814,36.834769,9970,1.806276,"2311959",
"345","1304302",Urucará,15639,10724,68.572159,4915,-2.274589,"1304302",
"346","4315305",Quaraí,22444,20553,91.574586,1891,-0.954188,"4315305",
"347","4101002",Ampére,16996,11607,68.292539,5389,1.21061,"4101002",
"348","2312007",Santana do Acaraú,28526,14281,50.0631,14245,1.22361,"2312007",
"349","1304401",Urucurituba,17030,8629,50.669407,8401,4.801845,"1304401",
"350","3169000",Tocantins,15631,12397,79.310345,3234,0.585603,"3169000",
"351","2312106",Santana do Cariri,17523,8920,50.904525,8603,0.563607,"2312106",
"352","4101101",Andirá,21255,19772,93.022818,1483,-0.271254,"4101101",
"353","2918753",Lagoa Real,13773,2727,19.799608,11046,1.091674,"2918753",
"354","2312205",Santa Quitéria,42886,20707,48.283822,22179,0.171388,"2312205",
"355","2312304",São Benedito,42956,23245,54.113512,19711,1.062034,"2312304",
"356","2918803",Laje,21048,5702,27.09046,15346,1.022694,"2918803",
"357","4101200",Antonina,17537,14658,83.583281,2879,-1.266797,"4101200",
"358","2312403",São Gonçalo do Amarante,40108,25041,62.433928,15067,1.714612,"2312403",
"359","4315503",Restinga Seca,15574,8792,56.453063,6782,-0.735545,"4315503",
"360","3169356",Três Marias,25809,24306,94.17645,1503,1.306076,"3169356",
"361","2312601",São Luís do Curu,12027,7810,64.937225,4217,0.645905,"2312601",
"362","2312700",Senador Pompeu,25199,14800,58.732489,10399,-1.098654,"2312700",
"363","2919108",Lamarão,11947,1914,16.020758,10033,3.292621,"2919108",
"364","4315701",Rio Pardo,37408,25702,68.707228,11706,-0.142394,"4315701",
"365","4101606",Arapoti,25535,18449,72.249853,7086,0.959449,"4101606",
"366","2919157",Lapão,25492,9838,38.5925,15654,0.436219,"2919157",
"367","3169604",Tupaciguara,22783,20586,90.356845,2197,-0.207693,"3169604",
"368","4101705",Araruna,12631,9524,75.401789,3107,-0.498847,"4101705",
"369","3169703",Turmalina,17183,11824,68.812198,5359,1.339321,"3169703",
"370","2313005",Solonópole,17304,8106,46.84466,9198,0.336361,"2313005",
"371","2919405",Licínio de Almeida,12670,6165,48.658248,6505,0.367271,"2919405",
"372","2313104",Tabuleiro do Norte,28176,17282,61.335889,10894,0.55885,"2313104",
"373","4316006",Rolante,19162,14701,76.719549,4461,1.017566,"4316006",
"374","2919504",Livramento de Nossa Senhora,42056,18975,45.118414,23081,1.449813,"2919504",
"375","2313203",Tamboril,25411,13203,51.957814,12208,-0.312018,"2313203",
"376","1400472",Rorainópolis,23482,9790,41.691508,13692,4.381358,"1400472",
"377","4101903",Assaí,16080,13031,81.038557,3049,-1.633544,"4101903",
"378","3170057",Ubaporanga,11979,6032,50.354788,5947,0.3593,"3170057",
"379","2919603",Macajuba,11169,6917,61.930343,4252,-0.384139,"2919603",
"380","4102000",Assis Chateaubriand,32065,27640,86.199906,4425,-0.545687,"4102000",
"381","2919702",Macarani,15922,12031,75.562115,3891,1.251934,"2919702",
"382","4102109",Astorga,24094,21152,87.789491,2942,0.27394,"4102109",
"383","2919801",Macaúbas,45903,14609,31.825807,31294,1.344539,"2919801",
"384","2313351",Tejuçuoca,15034,5120,34.056139,9914,1.528974,"2313351",
"385","4102307",Balsa Nova,10623,3940,37.089334,6683,0.648555,"4102307",
"386","2313500",Trairi,48501,15111,31.156059,33390,1.228755,"2313500",
"387","4316451",Salto do Jacuí,12059,10151,84.177793,1908,-1.010999,"4316451",
"388","4102406",Bandeirantes,32197,27701,86.035966,4496,-0.66313,"4102406",
"389","2313559",Tururu,13340,5431,40.712144,7909,2.145462,"2313559",
"390","4102505",Barbosa Ferraz,13423,10090,75.169485,3333,-0.710523,"4102505",
"391","1500206",Acará,47227,10776,22.817456,36451,-1.400079,"1500206",
"392","3170503",Urucânia,10170,7534,74.080629,2636,-0.284692,"3170503",
"393","2313609",Ubajara,29481,14119,47.891863,15362,1.212966,"2313609",
"394","1500305",Afuá,30946,8894,28.740386,22052,0.683526,"1500305",
"395","3170529",Urucuia,11278,5894,52.261039,5384,2.305161,"3170529",
"396","2920106",Mairi,19221,10590,55.095989,8631,-0.626172,"2920106",
"397","4316600",Sananduva,14653,9671,66.000136,4982,-0.088406,"4316600",
"398","1500347",Água Azul do Norte,28429,4491,15.797249,23938,3.673825,"1500347",
"399","2920205",Malhada,16050,6856,42.716511,9194,0.394216,"2920205",
"400","2313757",Umirim,18162,10679,58.79859,7483,0.661356,"2313757",
"401","2313807",Uruburetama,19155,12962,67.669016,6193,2.203981,"2313807",
"402","1500503",Almeirim,30213,18328,60.662629,11885,-1.655047,"1500503",
"403","4102802",Bela Vista do Paraíso,14849,13605,91.622331,1244,-0.17388,"4102802",
"404","2920403",Manoel Vitorino,14219,6595,46.381602,7624,-2.274717,"2920403",
"405","2313906",Uruoca,12967,7237,55.810905,5730,1.756511,"2313906",
"406","4102901",Bituruna,16098,7444,46.241769,8654,0.328175,"4102901",
"407","2920452",Mansidão,11638,3854,33.115656,7784,0.748606,"2920452",
"408","2313955",Varjota,17073,13840,81.063668,3233,0.408222,"2313955",
"409","1500701",Anajás,24652,9952,40.36995,14700,4.330509,"1500701",
"410","2920502",Maracás,34113,22530,66.045203,11583,1.061282,"2920502",
"411","2314003",Várzea Alegre,37682,21952,58.255931,15730,1.124874,"2314003",
"412","3170800",Várzea da Palma,34145,29914,87.608727,4231,1.093975,"3170800",
"413","2920601",Maragogipe,41879,22368,53.411017,19511,0.545564,"2920601",
"414","1500859",Anapu,17619,7412,42.068222,10207,9.378729,"1500859",
"415","3170909",Varzelândia,19022,9234,48.543791,9788,-0.109914,"3170909",
"416","2920700",Maraú,16849,3458,20.523473,13391,-1.224016,"2920700",
"417","2400109",Acari,10851,8512,78.444383,2339,-0.43724,"2400109",
"418","3171006",Vazante,19070,15480,81.17462,3590,0.10683,"3171006",
"419","1500909",Augusto Corrêa,36241,16599,45.801716,19642,1.342507,"1500909",
"420","2920809",Marcionílio Souza,10647,5356,50.30525,5291,-0.170575,"2920809",
"421","1500958",Aurora do Pará,21121,6461,30.590408,14660,0.979464,"1500958",
"422","2920908",Mascote,16020,12384,77.303371,3636,-0.064928,"2920908",
"423","2400307",Afonso Bezerra,10329,5770,55.862136,4559,-0.722736,"2400307",
"424","1501006",Aveiro,18791,3501,18.63126,15290,2.771678,"1501006",
"425","4317301",Santa Vitória do Palmar,30932,27023,87.362602,3909,-1.049967,"4317301",
"426","1501105",Bagre,18523,7743,41.802084,10780,4.394291,"1501105",
"427","2921054",Matina,12282,4080,33.219345,8202,2.628785,"2921054",
"428","2400505",Alexandria,13710,8906,64.959883,4804,-0.064437,"2400505",
"429","4317400",Santiago,49193,44628,90.720224,4565,-0.82717,"4317400",
"430","1501204",Baião,26017,14185,54.522043,11832,3.024509,"1501204",
"431","2921104",Medeiros Neto,21739,16479,75.803855,5260,0.335664,"2921104",
"432","2921203",Miguel Calmon,27149,15876,58.477292,11273,-0.574839,"2921203",
"433","2400703",Alto do Rodrigues,11370,7402,65.101143,3968,2.601723,"2400703",
"434","2921302",Milagres,11758,9560,81.306345,2198,-0.369894,"2921302",
"435","2400802",Angicos,11184,9535,85.255722,1649,-0.552181,"2400802",
"436","4317608",Santo Antônio da Patrulha,37731,26346,69.825873,11385,0.266334,"4317608",
"437","2921401",Mirangaba,17436,7509,43.06607,9927,2.913176,"2921401",
"438","4317707",Santo Antônio das Missões,11844,6865,57.961837,4979,-0.981886,"4317707",
"439","1501451",Belterra,12653,5419,42.827788,7234,-2.018159,"1501451",
"440","2401008",Apodi,34502,16770,48.605878,17732,0.136553,"2401008",
"441","4103453",Cafelândia,13011,10664,81.961417,2347,2.238744,"4103453",
"442","3171600",Virgem da Lapa,14084,6728,47.77052,7356,0.425036,"3171600",
"443","2401107",Areia Branca,24296,19455,80.074909,4841,1.083889,"2401107",
"444","4317806",Santo Augusto,13525,10630,78.595194,2895,-0.917088,"4317806",
"445","1501576",Bom Jesus do Tocantins,12688,7362,58.023329,5326,-0.461979,"1501576",
"446","2401206",Arês,12166,7326,60.216998,4840,1.031124,"2401206",
"447","4317905",Santo Cristo,14203,7043,49.588115,7160,-0.672537,"4317905",
"448","1501600",Bonito,11245,3516,31.26723,7729,1.963509,"1501600",
"449","3171808",Virginópolis,10813,6132,56.709516,4681,-0.018483,"3171808",
"450","2921708",Morro do Chapéu,33861,19131,56.498627,14730,-0.264243,"2921708",
"451","4103602",Cambará,23846,19261,80.772457,4585,0.680749,"4103602",
"452","2921807",Mortugaba,13888,5961,42.921947,7927,1.402416,"2921807",
"453","1501725",Brasil Novo,18669,7680,41.137715,10989,1.18355,"1501725",
"454","3172004",Visconde do Rio Branco,34468,28182,81.762794,6286,0.800047,"3172004",
"455","2921906",Mucugê,14006,4074,29.087534,9932,0.334913,"2921906",
"456","2401453",Baraúna,23077,14343,62.152793,8734,2.876468,"2401453",
"457","2922003",Mucuri,32855,24086,73.309998,8769,2.278244,"2922003",
"458","4318101",São Francisco de Assis,19445,13390,68.86089,6055,-0.964514,"4318101",
"858","2932408",Uibaí,13682,8042,58.777956,5640,0.071203,"2932408",
"459","4103909",Campina da Lagoa,15815,12642,79.936769,3173,-1.04186,"4103909",
"460","1501782",Breu Branco,46857,23591,50.3468,23266,5.390606,"1501782",
"461","2922052",Mulungu do Morro,13730,6515,47.450838,7215,-1.367267,"2922052",
"462","4318200",São Francisco de Paula,21124,13102,62.024238,8022,0.983706,"4318200",
"463","3167608",Simonésia,17221,6819,39.597004,10402,0.290368,"3167608",
"464","2922102",Mundo Novo,23720,12711,53.58769,11009,1.567587,"2922102",
"465","1501907",Bujaru,22474,8219,36.571149,14255,0.951844,"1501907",
"466","3129707",Ibiraci,10607,7079,66.738946,3528,0.519736,"3129707",
"467","4318408",São Jerônimo,20358,15608,76.667649,4750,0.05274,"4318408",
"468","1501956",Cachoeira do Piriá,17444,3847,22.053428,13597,1.761456,"1501956",
"469","3139003",Machado,37372,30276,81.012523,7096,0.991947,"3139003",
"470","2401800",Brejinho,11113,8369,75.308198,2744,1.067408,"2401800",
"471","1502004",Cachoeira do Arari,18907,7524,39.794785,11383,2.613553,"1502004",
"472","2922300",Muritiba,27167,17151,63.131741,10016,-1.705768,"2922300",
"473","3170008",Ubaí,11740,5619,47.86201,6121,1.234211,"3170008",
"474","2922409",Mutuípe,21085,9208,43.670856,11877,0.429382,"2922409",
"475","1502152",Canaã dos Carajás,23420,17889,76.383433,5531,11.513228,"1502152",
"476","2922508",Nazaré,26380,23107,87.592873,3273,0.008126,"2922508",
"477","3154903",Rio Casca,14353,11285,78.624678,3068,-0.871552,"3154903",
"478","2922607",Nilo Peçanha,12438,3004,24.151793,9434,1.492202,"2922607",
"479","2402105",Campo Redondo,10435,5435,52.084332,5000,1.814165,"2402105",
"480","4104402",Cândido de Abreu,17419,4607,26.448131,12812,-1.080256,"4104402",
"481","3200102",Afonso Cláudio,30674,14736,48.040686,15938,-0.705278,"3200102",
"482","2922656",Nordestina,12101,3576,29.551277,8525,0.360485,"2922656",
"483","2402204",Canguaretama,28575,18699,65.43832,9876,0.807356,"2402204",
"484","4104428",Candói,14973,6262,41.821946,8711,0.775326,"4104428",
"485","2922706",Nova Canaã,18766,8500,45.294682,10266,2.896726,"2922706",
"486","2402303",Caraúbas,19618,12931,65.913957,6687,0.60265,"2402303",
"487","4104451",Cantagalo,12327,7848,63.665125,4479,-0.547555,"4104451",
"488","1502509",Chaves,19276,1940,10.064329,17336,1.515197,"1502509",
"489","3200169",Água Doce do Norte,11759,6488,55.17476,5271,-1.150344,"3200169",
"490","4104501",Capanema,17960,10011,55.740535,7949,-0.219973,"4104501",
"491","4318507",São José do Norte,24851,18647,75.03521,6204,0.621646,"4318507",
"492","1502608",Colares,10922,3424,31.34957,7498,0.38518,"1502608",
"493","3200201",Alegre,30262,19783,65.372414,10479,-0.66727,"3200201",
"494","4104600",Capitão Leônidas Marques,13486,9786,72.564141,3700,-0.909802,"4104600",
"495","1502707",Conceição do Araguaia,44680,30932,69.230081,13748,0.420728,"1502707",
"496","3200300",Alfredo Chaves,13944,6433,46.134538,7511,0.340632,"3200300",
"497","4104659",Carambeí,16411,12531,76.357321,3880,1.428374,"4104659",
"498","1502756",Concórdia do Pará,21329,12105,56.753716,9224,0.252356,"1502756",
"499","2402709",Cerro Corá,10889,5013,46.037285,5876,0.06577,"2402709",
"500","1502764",Cumaru do Norte,10354,2476,23.913463,7878,8.163042,"1502764",
"501","4104709",Carlópolis,13101,8575,65.453019,4526,-0.22049,"4104709",
"502","3200409",Anchieta,19314,13553,70.171896,5761,0.102491,"3200409",
"504","4318804",São Lourenço do Sul,42216,23081,54.673583,19135,-0.48941,"4318804",
"505","1502772",Curionópolis,17596,12043,68.441691,5553,-1.446925,"1502772",
"506","2923001",Nova Viçosa,34479,26985,78.265031,7494,1.037377,"2923001",
"507","4318903",São Luiz Gonzaga,33996,30097,88.531004,3899,-2.139617,"4318903",
"508","1502806",Curralinho,25366,8969,35.358354,16397,3.441875,"1502806",
"509","2923035",Novo Horizonte,10167,3157,31.051441,7010,2.587858,"2923035",
"510","1502855",Curuá,11802,5028,42.602949,6774,3.583577,"1502855",
"511","4319000",São Marcos,19595,16702,85.23603,2893,0.473237,"4319000",
"512","2923050",Novo Triunfo,14133,6114,43.260454,8019,0.551748,"2923050",
"513","2403103",Currais Novos,41978,37281,88.810806,4697,0.410615,"2403103",
"514","4105102",Centenário do Sul,11047,9182,83.117588,1865,-0.957957,"4105102",
"515","1502905",Curuçá,33685,12985,38.548315,20700,3.677745,"1502905",
"516","3200805",Baixo Guandu,28502,21443,75.233317,7059,0.347101,"3200805",
"517","2923100",Olindina,23740,12343,51.992418,11397,-0.101285,"2923100",
"518","4105201",Cerro Azul,17577,5708,32.474256,11869,1.037358,"4105201",
"519","1502939",Dom Eliseu,38017,26102,68.658758,11915,-0.55561,"1502939",
"520","2923209",Oliveira dos Brejinhos,22533,6545,29.046288,15988,0.559446,"2923209",
"521","3200904",Barra de São Francisco,39201,24541,62.602995,14660,0.598613,"3200904",
"522","4105300",Céu Azul,10873,7925,72.886968,2948,0.575353,"4105300",
"523","1502954",Eldorado dos Carajás,28273,15141,53.55286,13132,-0.656937,"1502954",
"524","3201001",Boa Esperança,12854,9435,73.401276,3419,-0.884731,"3201001",
"525","1503002",Faro,17243,12985,75.305921,4258,8.037046,"1503002",
"526","4105409",Chopinzinho,19030,10889,57.220179,8141,-1.086958,"4105409",
"527","2923357",Ourolândia,16262,5400,33.206248,10862,0.822288,"2923357",
"528","1503044",Floresta do Araguaia,14912,6046,40.544528,8866,0.616553,"1503044",
"529","2923407",Palmas de Monte Alto,21046,8367,39.755773,12679,0.659889,"2923407",
"530","3201159",Brejetuba,10891,2755,25.296116,8136,-1.002659,"3201159",
"531","2403509",Espírito Santo,10109,5099,50.440202,5010,-0.828244,"2403509",
"532","4105607",Cidade Gaúcha,10442,8581,82.177744,1861,1.312633,"4105607",
"533","1503077",Garrafão do Norte,24575,8907,36.244151,15668,0.207496,"1503077",
"534","4105706",Clevelândia,17455,14550,83.357204,2905,-0.70251,"4105706",
"535","1503093",Goianésia do Pará,26873,18457,68.682321,8416,2.449785,"1503093",
"536","2923605",Paramirim,19991,8997,45.005252,10994,0.78895,"2923605",
"537","4319406",São Pedro do Sul,16546,11817,71.419074,4729,-0.376741,"4319406",
"538","1503101",Gurupá,24279,7281,29.988879,16998,0.714911,"1503101",
"539","2923704",Paratinga,28634,9557,33.376406,19077,0.485759,"2923704",
"540","3201407",Castelo,32199,19092,59.293767,13107,-0.244711,"3201407",
"541","4105904",Colorado,20892,19187,91.838981,1705,-0.044367,"4105904",
"542","4319505",São Sebastião do Caí,20322,16284,80.129908,4038,0.445065,"4319505",
"543","1503200",Igarapé-Açu,33633,19768,58.775607,13865,0.534987,"1503200",
"544","2923803",Paripiranga,28303,8978,31.721019,19325,0.895341,"2923803",
"545","4319604",São Sepé,23633,18422,77.950324,5211,-0.583373,"4319604",
"546","3201605",Conceição da Barra,26045,18731,71.917835,7314,-0.24388,"3201605",
"547","2923902",Pau Brasil,12133,8047,66.323251,4086,-1.03328,"2923902",
"548","3201704",Conceição do Castelo,11218,5365,47.824924,5853,0.398504,"3201704",
"549","4106209",Contenda,14549,7879,54.154925,6670,1.35487,"4106209",
"550","1503457",Ipixuna do Pará,38870,9916,25.510677,28954,6.424237,"1503457",
"551","2924058",Pé de Serra,14147,4994,35.30077,9153,0.638016,"2924058",
"552","4106308",Corbélia,15382,13036,84.748407,2346,-0.384997,"4106308",
"553","1503507",Irituia,29585,6461,21.83877,23124,-0.442578,"1503507",
"554","3201902",Domingos Martins,31138,7821,25.11722,23317,0.268498,"3201902",
"555","2404200",Goianinha,20276,14300,70.526731,5976,1.992142,"2404200",
"556","4106407",Cornélio Procópio,46638,43593,93.470989,3045,-0.068121,"4106407",
"557","2924207",Pedro Alexandre,16892,2607,15.433341,14285,-0.051482,"2924207",
"558","2404309",Governador Dix-Sept Rosado,12308,6469,52.559311,5839,0.638108,"2404309",
"559","1503705",Itupiranga,41611,18363,44.130158,23248,-2.493173,"1503705",
"560","2924306",Piatã,18017,7180,39.851252,10837,-0.738856,"2924306",
"561","3202108",Ecoporanga,23122,14026,60.660842,9096,-0.518564,"3202108",
"562","1503754",Jacareacanga,34310,5600,16.321772,28710,5.223022,"1503754",
"563","4106506",Coronel Vivida,21183,14428,68.111221,6755,-1.355189,"4106506",
"564","2924405",Pilão Arcado,32124,9734,30.301332,22390,0.64374,"2924405",
"565","3202207",Fundão,15114,12901,85.357946,2213,2.16569,"3202207",
"566","2404507",Guamaré,11499,4222,36.716236,7277,5.042514,"2404507",
"567","2924504",Pindaí,15294,3946,25.800968,11348,-0.185432,"2924504",
"568","3202306",Guaçuí,25650,19721,76.88499,5929,0.088309,"3202306",
"569","2404606",Ielmo Marinho,11551,1421,12.301965,10130,1.723133,"2404606",
"570","1503903",Juruti,33559,12363,36.839596,21196,1.047608,"1503903",
"571","4320107",Sarandi,20159,16654,82.613225,3505,1.501436,"4320107",
"572","2924603",Pindobaçu,20041,10793,53.854598,9248,-0.576683,"2924603",
"573","2404705",Ipanguaçu,13412,5092,37.966001,8320,1.694143,"2404705",
"574","4320206",Seberi,10816,5651,52.246672,5165,-0.684832,"4320206",
"575","4106605",Cruzeiro do Oeste,20000,16976,84.88,3024,-0.157574,"4106605",
"576","1504000",Limoeiro do Ajuru,23251,5939,25.542987,17312,2.497199,"1504000",
"577","3202454",Ibatiba,19612,11836,60.350806,7776,0.296305,"3202454",
"578","2924652",Pintadas,10543,5095,48.325903,5448,-0.509763,"2924652",
"579","1504059",Mãe do Rio,27532,22222,80.713352,5310,1.185989,"1504059",
"580","3202504",Ibiraçu,10289,7474,72.640684,2815,0.204374,"3202504",
"581","4106803",Cruz Machado,18214,4020,22.070934,14194,0.436551,"4106803",
"582","2924702",Piripá,13467,6564,48.741368,6903,-2.54303,"2924702",
"583","3202603",Iconha,11457,6250,54.551802,5207,-0.02989,"3202603",
"584","2924801",Piritiba,24128,15098,62.574602,9030,3.443513,"2924801",
"585","1504307",Maracanã,28227,11173,39.582669,17054,0.336486,"1504307",
"586","3202652",Irupi,10282,3764,36.607664,6518,-0.099638,"3202652",
"587","1504406",Marapanim,26579,9235,34.745476,17344,1.042391,"1504406",
"588","3202702",Itaguaçu,13810,7429,53.794352,6381,-0.689197,"3202702",
"589","2925006",Planalto,21464,13768,64.144614,7696,-0.160695,"2925006",
"590","4320404",Serafina Corrêa,13404,11115,82.923008,2289,3.006318,"4320404",
"591","3202801",Itapemirim,30623,19530,63.775594,11093,1.225082,"3202801",
"592","2925105",Poções,44628,32509,72.844403,12119,0.133555,"2925105",
"593","1504455",Medicilândia,22392,7953,35.517149,14439,0.663543,"1504455",
"594","3202900",Itarana,10543,3807,36.109267,6736,-1.141179,"3202900",
"595","2925204",Pojuca,29977,26096,87.053408,3881,1.94083,"2925204",
"596","4107207",Dois Vizinhos,33898,25073,73.966016,8825,0.832845,"4107207",
"597","1504505",Melgaço,17716,3999,22.572816,13717,-2.442494,"1504505",
"598","3203007",Iúna,25455,15031,59.049303,10424,-0.363378,"3203007",
"599","2925253",Ponto Novo,14794,7878,53.251318,6916,-2.119105,"2925253",
"600","1504604",Mocajuba,23211,16531,71.220542,6680,1.760383,"1504604",
"601","3203056",Jaguaré,21829,13304,60.946447,8525,1.595841,"3203056",
"602","2405603",Jardim de Piranhas,13668,10565,77.297337,3103,1.883967,"2405603",
"603","3203106",Jerônimo Monteiro,10673,7928,74.280896,2745,0.665181,"3203106",
"604","2925402",Potiraguá,10327,6550,63.425971,3777,-4.806645,"2925402",
"605","2405702",Jardim do Seridó,11966,9533,79.667391,2433,-0.08922,"2405702",
"606","4107504",Engenheiro Beltrão,13831,11421,82.575374,2410,-0.256598,"4107504",
"607","3203130",João Neiva,14395,11759,81.688086,2636,-0.86817,"3203130",
"608","2925501",Prado,24751,14477,58.490566,10274,-0.969603,"2925501",
"609","2405801",João Câmara,30340,20899,68.882663,9441,0.525027,"2405801",
"610","1504901",Muaná,28672,10931,38.124302,17741,1.707813,"1504901",
"611","2925600",Presidente Dutra,13742,8196,59.641974,5546,0.012481,"2925600",
"612","3203163",Laranja da Terra,10741,2992,27.855879,7749,-0.254091,"3203163",
"613","4320677",Sinimbu,10209,1361,13.331374,8848,-0.001399,"4320677",
"614","1504950",Nova Esperança do Piriá,22197,7760,34.959679,14437,2.329076,"1504950",
"615","2925709",Presidente Jânio Quadros,14768,3858,26.124052,10910,-2.02765,"2925709",
"616","4320701",Sobradinho,13991,11102,79.351011,2889,-2.182505,"4320701",
"617","1504976",Nova Ipixuna,14028,7923,56.479897,6105,2.419933,"1504976",
"618","3203304",Mantenópolis,11376,6983,61.383615,4393,-0.995187,"3203304",
"619","2925758",Presidente Tancredo Neves,22440,8060,35.918004,14380,2.098368,"2925758",
"620","2406106",Jucurutu,17429,10456,59.991967,6973,0.090488,"2406106",
"621","4320800",Soledade,29554,23299,78.835352,6255,-0.083346,"4320800",
"622","1505007",Nova Timboteua,12085,4664,38.593297,7421,0.8295,"1505007",
"623","3203320",Marataízes,31000,24002,77.425806,6998,0.1843,"3203320",
"624","2925808",Queimadas,26968,12971,48.097745,13997,1.313932,"2925808",
"625","1505031",Novo Progresso,21509,17535,81.524013,3974,-2.096598,"1505031",
"626","4107603",Faxinal,15445,11248,72.826157,4197,-0.149863,"4107603",
"627","3203346",Marechal Floriano,12642,6005,47.500396,6637,0.523835,"3203346",
"628","2925907",Quijingue,27022,6205,22.962771,20817,0.346267,"2925907",
"629","4320909",Tapejara,17463,15133,86.657504,2330,2.084233,"4320909",
"630","3203353",Marilândia,10211,4826,47.262756,5385,0.408109,"3203353",
"631","1505106",Óbidos,46462,23581,50.753304,22881,-0.008606,"1505106",
"632","4321006",Tapera,10395,8638,83.097643,1757,-0.230122,"4321006",
"633","3203403",Mimoso do Sul,25974,14695,56.575807,11279,-0.123141,"3203403",
"634","2925956",Rafael Jambeiro,23049,5927,25.714782,17122,0.281431,"2925956",
"635","2406502",Lagoa Nova,13126,6107,46.525979,7019,1.21976,"2406502",
"636","4321105",Tapes,16306,14480,88.801668,1826,0.013148,"4321105",
"637","1505205",Oeiras do Pará,25327,10206,40.296916,15121,1.226762,"1505205",
"638","2926004",Remanso,37783,21446,56.760977,16337,0.590692,"2926004",
"639","3203502",Montanha,17579,13314,75.738097,4265,0.259472,"3203502",
"640","2926103",Retirolândia,11922,6375,53.472572,5547,1.300508,"2926103",
"641","2406700",Lajes,10344,8284,80.085073,2060,1.378028,"2406700",
"642","4321303",Taquari,25562,21365,83.581097,4197,-0.180323,"4321303",
"643","1505403",Ourém,14930,7367,49.343603,7563,0.520676,"1505403",
"644","2926202",Riachão das Neves,22422,10632,47.417715,11790,0.325959,"2926202",
"645","3203700",Muniz Freire,18171,7486,41.197513,10685,-1.139645,"3203700",
"646","1505437",Ourilândia do Norte,20008,13523,67.587965,6485,0.389414,"1505437",
"647","3203809",Muqui,13773,9068,65.83896,4705,0.107293,"3203809",
"648","2926301",Riachão do Jacuípe,32429,16616,51.238089,15813,0.355662,"2926301",
"649","1505486",Pacajá,38116,13857,36.354812,24259,4.03957,"1505486",
"650","2926400",Riacho de Santana,29321,12239,41.741414,17082,0.334772,"2926400",
"651","3203908",Nova Venécia,44077,29020,65.839327,15057,0.349025,"3203908",
"652","4321402",Tenente Portela,13837,8505,61.465636,5332,-0.51177,"4321402",
"653","4108007",Florestópolis,11548,10351,89.634569,1197,-0.76993,"4108007",
"654","3204005",Pancas,18280,9256,50.634573,9024,-1.55669,"3204005",
"655","2926509",Ribeira do Amparo,14075,1919,13.634103,12156,0.175805,"2926509",
"656","3204054",Pedro Canário,23120,21343,92.314014,1777,0.737418,"3204054",
"657","2926608",Ribeira do Pombal,47212,27864,59.018894,19348,0.288333,"2926608",
"658","2407203",Macau,26890,20870,77.612495,6020,0.648716,"2407203",
"659","4321451",Teutônia,25005,21193,84.755049,3812,1.269881,"4321451",
"660","2926657",Ribeirão do Largo,14037,6076,43.285602,7961,-1.226025,"2926657",
"661","3204104",Pinheiros,22613,18074,79.927475,4539,0.844681,"3204104",
"662","2926707",Rio de Contas,13401,5970,44.548914,7431,-0.55665,"2926707",
"663","3204203",Piúma,16134,15278,94.694434,856,1.059079,"3204203",
"664","2926806",Rio do Antônio,15056,5602,37.207758,9454,0.404014,"2926806",
"665","4321501",Torres,32098,28783,89.672254,3315,0.554173,"4321501",
"666","1505635",Piçarra,12645,3376,26.6983,9269,-0.029339,"1505635",
"667","2926905",Rio do Pires,11373,4745,41.721621,6628,-0.775513,"2926905",
"668","3204302",Presidente Kennedy,10262,3528,34.379263,6734,1.024977,"3204302",
"669","1505650",Placas,17527,3821,21.80065,13706,3.916695,"1505650",
"670","4321600",Tramandaí,39603,38585,97.429488,1018,3.541677,"4321600",
"671","3204351",Rio Bananal,16552,5506,33.264862,11046,0.198347,"3204351",
"672","2927002",Rio Real,35970,22327,62.07117,13643,1.125281,"2927002",
"673","4108502",General Carneiro,14107,9929,70.383498,4178,0.212429,"4108502",
"674","1505700",Ponta de Pedras,24228,11146,46.004623,13082,3.773844,"1505700",
"675","3204401",Rio Novo do Sul,11074,5916,53.422431,5158,-0.251584,"3204401",
"676","2407708",Montanhas,12361,9452,76.466305,2909,0.486644,"2407708",
"677","1505809",Portel,45247,22000,48.622008,23247,2.508361,"1505809",
"678","2927200",Ruy Barbosa,29299,21046,71.831803,8253,0.133824,"2927200",
"679","3204500",Santa Leopoldina,12314,2460,19.977262,9854,-0.171673,"3204500",
"680","2407807",Monte Alegre,20524,8303,40.455077,12221,1.204476,"2407807",
"681","4108601",Goioerê,28727,24808,86.357782,3919,-0.498634,"4108601",
"682","1505908",Porto de Moz,25896,13201,50.976985,12695,1.368929,"1505908",
"683","4321667",Três Cachoeiras,10365,6978,67.322721,3387,1.217709,"4321667",
"684","3204559",Santa Maria de Jetibá,31767,10288,32.385809,21479,1.423694,"3204559",
"685","2927309",Salinas da Margarida,13048,5713,43.784488,7335,3.326164,"2927309",
"686","1506005",Prainha,26339,7648,29.03679,18691,-0.511155,"1506005",
"687","4321709",Três Coroas,22783,20268,88.961067,2515,2.300292,"4321709",
"688","3204609",Santa Teresa,20052,10224,50.987433,9828,-0.399622,"3204609",
"689","4321808",Três de Maio,23251,18067,77.704185,5184,-0.532241,"4321808",
"690","1506104",Primavera,10362,6645,64.128547,3717,0.920863,"1506104",
"691","2927507",Santa Bárbara,19394,8003,41.26534,11391,1.125156,"2927507",
"692","4108809",Guaíra,28529,25473,89.288093,3056,-0.064928,"4108809",
"693","1506112",Quatipuru,11769,5802,49.299006,5967,1.095205,"1506112",
"694","3204708",São Gabriel da Palha,28769,21449,74.555946,7320,1.13263,"3204708",
"695","2927606",Santa Brígida,15453,4919,31.832007,10534,-1.273083,"2927606",
"696","3204807",São José do Calçado,10537,7898,74.954921,2639,0.076154,"3204807",
"697","2927705",Santa Cruz Cabrália,24362,17099,70.187177,7263,0.281084,"2927705",
"698","2408300",Nova Cruz,35133,23859,67.910511,11274,0.53966,"2408300",
"699","4321907",Três Passos,23182,17807,76.813907,5375,-0.876765,"4321907",
"700","1506161",Rio Maria,16890,12874,76.222617,4016,-0.503938,"1506161",
"701","1506187",Rondon do Pará,44595,32297,72.422917,12298,1.612833,"1506187",
"702","3204955",São Roque do Canaã,10427,5071,48.633356,5356,0.043919,"3204955",
"703","2927903",Santa Inês,10494,9447,90.02287,1047,-0.705261,"2927903",
"704","1506195",Rurópolis,32821,12173,37.089059,20648,4.168632,"1506195",
"705","4322004",Triunfo,23918,14603,61.054436,9315,1.092665,"4322004",
"706","2928000",Santaluz,33309,20272,60.860428,13037,1.052545,"2928000",
"707","1506203",Salinópolis,36729,32931,89.659397,3798,1.345323,"1506203",
"708","3205010",Sooretama,21838,14845,67.977837,6993,2.581998,"3205010",
"709","2928059",Santa Luzia,15007,8351,55.647365,6656,-0.463448,"2928059",
"710","4109302",Guaraniaçu,15864,7904,49.8235,7960,-1.149275,"4109302",
"711","1506302",Salvaterra,17029,11462,67.308709,5567,1.714993,"1506302",
"712","2928109",Santa Maria da Vitória,40421,23074,57.084189,17347,-0.293401,"2928109",
"713","3205036",Vargem Alta,17752,5402,30.430374,12350,0.3063,"3205036",
"714","1506351",Santa Bárbara do Pará,13369,4167,31.169123,9202,2.33041,"1506351",
"715","2928208",Santana,25889,13314,51.427247,12575,1.004863,"2928208",
"716","3205069",Venda Nova do Imigrante,18598,12744,68.523497,5854,2.023131,"3205069",
"717","2408904",Parelhas,19890,16502,82.966315,3388,0.416982,"2408904",
"718","4322202",Tupanciretã,22369,17758,79.386651,4611,0.942711,"4322202",
"719","4109609",Guaratuba,30703,27075,88.183565,3628,1.715259,"4109609",
"720","1506500",Santa Isabel do Pará,49968,38404,76.857189,11564,2.091828,"1506500",
"721","2928406",Santa Rita de Cássia,25963,13420,51.688942,12543,1.113813,"2928406",
"722","2409100",Passa e Fica,10363,5991,57.811445,4372,3.170632,"2409100",
"723","1506559",Santa Luzia do Pará,18038,8959,49.667369,9079,-1.034504,"1506559",
"724","3205176",Vila Valério,13560,4850,35.766962,8710,-0.327525,"3205176",
"725","1506583",Santa Maria das Barreiras,15732,4603,29.258835,11129,5.305991,"1506583",
"726","4109708",Ibaiti,27851,21816,78.331119,6035,0.741138,"4109708",
"727","2409308",Patu,11278,9067,80.39546,2211,0.136275,"2409308",
"728","1506609",Santa Maria do Pará,22071,12012,54.424358,10059,0.816322,"1506609",
"729","1506708",Santana do Araguaia,48511,28416,58.576405,20095,6.499576,"1506708",
"730","2928802",Santo Estêvão,44334,23476,52.952587,20858,1.072127,"2928802",
"731","2409407",Pau dos Ferros,26554,24018,90.44965,2536,1.005474,"2409407",
"732","2928901",São Desidério,24984,8186,32.76497,16798,3.984192,"2928901",
"733","1507003",Santo Antônio do Tauá,24773,13513,54.547289,11260,3.226771,"1507003",
"734","3300225",Areal,10968,9542,86.998541,1426,1.475758,"3300225",
"735","2929008",São Félix,15266,10080,66.029084,5186,1.55925,"2929008",
"736","4110078",Imbaú,11160,6908,61.899642,4252,2.36737,"4110078",
"737","1507102",São Caetano de Odivelas,16132,6673,41.364989,9459,0.484808,"1507102",
"738","2929057",São Félix do Coribe,12745,9705,76.147509,3040,1.158158,"2929057",
"739","3300233",Armação dos Búzios,24274,24274,100,0,4.196589,"3300233",
"740","2409803",Pedro Velho,13604,6103,44.861805,7501,0.090637,"2409803",
"741","4322533",Vale do Sol,10785,1122,10.403338,9663,0.304354,"4322533",
"742","4110102",Imbituva,26888,16761,62.336358,10127,1.339901,"4110102",
"859","4113502",Loanda,19304,17178,88.986738,2126,-0.180006,"4113502",
"743","1507151",São Domingos do Araguaia,21040,13712,65.171103,7328,0.723219,"1507151",
"744","3300258",Arraial do Cabo,25183,25183,100,0,0.763666,"3300258",
"745","2929107",São Felipe,20201,8931,44.210683,11270,-0.019079,"2929107",
"746","2409902",Pendências,12470,9820,78.748998,2650,1.288584,"2409902",
"747","4110201",Inácio Martins,10866,5942,54.684336,4924,-0.126881,"4110201",
"748","1507201",São Domingos do Capim,26825,6082,22.67288,20743,-0.305122,"1507201",
"749","2929255",São Gabriel,18399,10137,55.095386,8262,-0.01009,"2929255",
"750","2410108",Poço Branco,12235,6951,56.812423,5284,-0.030321,"2410108",
"751","1507409",São Francisco do Pará,11889,4604,38.724872,7285,-2.54968,"1507409",
"752","2929305",São Gonçalo dos Campos,29143,14305,49.085544,14838,1.097087,"2929305",
"753","4322707",Vera Cruz,22652,12134,53.567014,10518,0.883034,"4322707",
"754","4110508",Ipiranga,13973,4721,33.786588,9252,0.699025,"4110508",
"755","1507458",São Geraldo do Araguaia,24781,12895,52.035834,11886,-1.550762,"1507458",
"756","3300506",Bom Jardim,24468,13768,56.269413,10700,1.108414,"3300506",
"757","4110607",Iporã,15029,11498,76.505423,3531,-1.278046,"4110607",
"758","4322806",Veranópolis,23353,20164,86.344367,3189,2.634917,"4322806",
"759","3300605",Bom Jesus do Itabapoana,33312,27774,83.37536,5538,-0.146235,"3300605",
"760","2929370",São José do Jacuípe,10475,6721,64.162291,3754,1.819315,"2929370",
"761","1507474",São João de Pirabas,18595,10122,54.433988,8473,0.883978,"1507474",
"762","2929404",São Miguel das Matas,10212,3209,31.423815,7003,0.271517,"2929404",
"763","1507508",São João do Araguaia,11448,2510,21.925227,8938,-0.95917,"1507508",
"764","4110805",Iretama,11040,5716,51.775362,5324,-0.376009,"4110805",
"765","1507607",São Miguel do Guamá,42856,27106,63.24902,15750,0.506799,"1507607",
"766","3300902",Cambuci,14338,10579,73.782954,3759,-0.326484,"3300902",
"767","2929602",Sapeaçu,16466,8090,49.131544,8376,0.013889,"2929602",
"768","1507706",São Sebastião da Boa Vista,20446,8681,42.458183,11765,2.111389,"1507706",
"769","3300936",Carapebus,10578,8625,81.537153,1953,2.889076,"3300936",
"770","2929701",Sátiro Dias,17937,3884,21.653565,14053,0.558633,"2929701",
"771","2929750",Saubara,10957,10665,97.335037,292,1.037882,"2929750",
"772","2929800",Saúde,11845,6452,54.470241,5393,0.43814,"2929800",
"773","1507904",Soure,21331,19281,90.389574,2050,0.954979,"1507904",
"774","3301108",Cantagalo,19643,13339,67.907142,6304,-0.138861,"3301108",
"775","2929909",Seabra,40462,18585,45.931986,21877,0.372682,"2929909",
"776","4111209",Itapejara d'Oeste,10481,6550,62.494037,3931,1.940001,"4111209",
"777","2930006",Sebastião Laranjeiras,10666,4036,37.839865,6630,2.003759,"2930006",
"778","3301157",Cardoso Moreira,12175,8581,70.480493,3594,-0.483332,"3301157",
"779","3301207",Carmo,16405,12458,75.940262,3947,1.011547,"3301207",
"780","1507979",Terra Santa,15303,10556,68.979939,4747,0.681964,"1507979",
"781","2930154",Serra do Ramalho,30503,5263,17.254041,25240,-0.945321,"2930154",
"782","3301306",Casimiro de Abreu,26976,23308,86.402728,3668,2.854552,"3301306",
"783","2411205",Santa Cruz,33670,27992,83.136323,5678,1.050925,"2411205",
"784","4111407",Ivaí,12639,4318,34.164095,8321,0.865624,"4111407",
"785","1508001",Tomé-Açu,46489,28324,60.926241,18165,-0.238623,"1508001",
"786","2930204",Sento Sé,36325,20961,57.704061,15364,1.619645,"2930204",
"787","3301405",Conceição de Macabu,19288,16832,87.266694,2456,0.380496,"3301405",
"788","2411403",Santana do Matos,14281,6575,46.040193,7706,-1.59916,"2411403",
"789","4111506",Ivaiporã,31158,26212,84.126067,4946,-0.499704,"4111506",
"790","1508035",Tracuateua,25694,6599,25.683039,19095,1.758135,"1508035",
"791","2930303",Serra Dourada,17343,5762,33.223779,11581,-0.541611,"2930303",
"792","3301504",Cordeiro,18967,18358,96.78916,609,0.278749,"3301504",
"793","1508050",Trairão,15980,5871,36.739675,10109,1.864091,"1508050",
"794","3301603",Duas Barras,10412,6779,65.107568,3633,0.10748,"3301603",
"795","2930402",Serra Preta,15039,6275,41.724849,8764,-2.321007,"2930402",
"796","2411502",Santo Antônio,21222,13325,62.788616,7897,0.773985,"2411502",
"797","1508084",Tucumã,25978,20089,77.330818,5889,0.373409,"1508084",
"798","4323804",Xangri-lá,10581,10514,99.36679,67,3.714344,"4323804",
"799","4316402",Rosário do Sul,40282,35602,88.381908,4680,-0.272214,"4316402",
"800","3301801",Engenheiro Paulo de Frontin,12420,9025,72.665056,3395,0.297976,"3301801",
"801","2930600",Serrolândia,12100,6969,57.595041,5131,-0.594801,"2930600",
"802","4111803",Jacarezinho,39108,34471,88.143091,4637,-0.187441,"4111803",
"803","1508126",Ulianópolis,30039,22950,76.400679,7089,6.560176,"1508126",
"804","1508159",Uruará,34749,18916,54.436099,15833,-3.687003,"1508159",
"805","4111902",Jaguapitã,11625,9814,84.421505,1811,0.881919,"4111902",
"806","2930758",Sítio do Mato,12413,6412,51.655522,6001,0.78479,"2930758",
"807","3301876",Iguaba Grande,19683,19683,100,0,3.869997,"3301876",
"808","5000203",Água Clara,13080,8931,68.279817,4149,2.485037,"5000203",
"809","4112009",Jaguariaíva,31793,27572,86.723493,4221,0.463657,"4112009",
"810","1508209",Vigia,43775,30034,68.609937,13741,1.233157,"1508209",
"811","2930766",Sítio do Quinto,13748,4578,33.299389,9170,-3.01285,"2930766",
"812","4112108",Jandaia do Sul,19394,17328,89.347221,2066,-0.206014,"4112108",
"813","2930774",Sobradinho,21139,19051,90.122522,2088,-0.125071,"2930774",
"814","5000609",Amambaí,32990,19515,59.154289,13475,1.618047,"5000609",
"815","2930808",Souto Soares,17974,6144,34.182708,11830,2.819546,"2930808",
"816","3302056",Italva,13583,9871,72.671722,3712,1.05491,"3302056",
"817","5000708",Anastácio,22242,18017,81.004406,4225,-0.150033,"5000708",
"818","1508407",Xinguara,37994,29389,77.351687,8605,1.088946,"1508407",
"819","2930907",Tabocas do Brejo Velho,12244,3702,30.235217,8542,-0.430038,"2930907",
"820","3302106",Itaocara,21973,15956,72.616393,6017,-0.652295,"3302106",
"821","2412302",São José do Campestre,11730,9623,82.037511,2107,-0.303195,"2412302",
"822","1507805",Senador José Porfírio,14123,6185,43.793812,7938,-1.519659,"1507805",
"823","2931004",Tanhaçu,19575,7954,40.633461,11621,-0.337666,"2931004",
"824","4112504",Jardim Alegre,14292,7604,53.20459,6688,0.634531,"4112504",
"825","3302254",Itatiaia,30959,29144,94.137408,1815,3.255922,"3302254",
"826","2931053",Tanque Novo,15710,6348,40.407384,9362,-0.055347,"2931053",
"827","2412500",São Miguel,22510,13156,58.445135,9354,1.613544,"2412500",
"828","5001003",Aparecida do Taboado,19692,17376,88.238879,2316,0.972601,"5001003",
"829","4112702",Jataizinho,11154,10434,93.544917,720,-0.219631,"4112702",
"830","2931202",Taperoá,18056,8293,45.929331,9763,1.802999,"2931202",
"831","2412609",São Paulo do Potengi,14411,11067,76.795503,3344,0.597927,"2412609",
"832","5001102",Aquidauana,44408,34950,78.702036,9458,0.315338,"5001102",
"833","2931301",Tapiramutá,17201,12522,72.798093,4679,0.116816,"2931301",
"834","4112801",Joaquim Távora,10172,7639,75.098309,2533,0.739027,"4112801",
"835","2931509",Teofilândia,20651,6086,29.470728,14565,0.152422,"2931509",
"836","2412906",São Tomé,11055,6040,54.635911,5015,0.336592,"2412906",
"837","5001904",Bataguassu,18482,13731,74.293908,4751,1.903188,"5001904",
"838","2931608",Teolândia,12313,4120,33.46057,8193,-0.296937,"2931608",
"839","5002001",Batayporã,10411,7474,71.789453,2937,-0.290246,"5002001",
"840","2931707",Terra Nova,12280,10837,88.249186,1443,-0.673657,"2931707",
"841","5002100",Bela Vista,22310,18000,80.681309,4310,0.354595,"5002100",
"842","3302809",Mendes,17235,17087,99.141282,148,-0.044679,"3302809",
"843","2931806",Tremedal,18475,3890,21.05548,14585,-1.946278,"2931806",
"844","4113205",Lapa,41510,24731,59.578415,16779,-0.112375,"4113205",
"845","3302908",Miguel Pereira,24543,21273,86.676445,3270,0.37878,"3302908",
"846","2931905",Tucano,48588,19676,40.495596,28912,-0.675266,"2931905",
"847","5002209",Bonito,17073,13446,78.75593,3627,0.098284,"5002209",
"848","3303005",Miracema,26131,24216,92.67154,1915,-0.499919,"3303005",
"849","2932002",Uauá,24591,10053,40.88081,14538,-0.788968,"2932002",
"850","5002308",Brasilândia,12051,7729,64.135756,4322,0.113127,"5002308",
"851","4113304",Laranjeiras do Sul,30039,23926,79.649789,6113,0.00666,"4113304",
"852","3303104",Natividade,14846,11808,79.536576,3038,-0.265626,"3303104",
"853","2932101",Ubaíra,20590,8463,41.102477,12127,-0.003469,"2932101",
"854","5002407",Caarapó,22565,15838,70.188345,6727,1.23581,"5002407",
"855","2932200",Ubaitaba,20345,17859,87.780782,2486,-2.247456,"2932200",
"856","5002605",Camapuã,13111,9578,73.053161,3533,-3.185733,"5002605",
"857","2932309",Ubatã,24756,17449,70.483923,7307,1.831139,"2932309",
"860","2932457",Umburanas,16045,7397,46.101589,8648,1.821965,"2932457",
"861","5002902",Cassilândia,20663,18608,90.054687,2055,0.4047,"5002902",
"862","2932507",Una,25101,14288,56.922035,10813,-3.086557,"2932507",
"863","5002951",Chapadão do Sul,16116,13131,81.478034,2985,4.734667,"5002951",
"864","3303708",Paraíba do Sul,39053,33962,86.96387,5091,0.615913,"3303708",
"865","2932606",Urandi,15805,5462,34.558684,10343,-0.242579,"2932606",
"866","2413904",Taipu,11707,4118,35.175536,7589,0.216633,"2413904",
"867","3303807",Parati,32523,14786,45.463211,17737,1.381844,"3303807",
"868","2932705",Uruçuca,21916,17500,79.850338,4416,1.083885,"2932705",
"869","2414001",Tangará,12991,8776,67.554461,4215,0.998738,"2414001",
"870","5003157",Coronel Sapucaia,13860,10201,73.600289,3659,1.131798,"5003157",
"871","3303856",Paty do Alferes,24985,17613,70.494297,7372,0.030914,"3303856",
"872","2932804",Utinga,19125,12982,67.879739,6143,1.792066,"2932804",
"873","1600279",Laranjal do Jari,37392,35488,94.908002,1904,3.947739,"1600279",
"874","5003256",Costa Rica,18090,14636,80.906578,3454,2.243274,"5003256",
"875","4113908",Mallet,12352,7109,57.553433,5243,-0.285841,"4113908",
"876","2933000",Valente,21469,11484,53.49108,9985,1.650159,"2933000",
"877","2414209",Tibau do Sul,10793,6867,63.624571,3926,4.847154,"2414209",
"878","5003306",Coxim,31712,28427,89.641145,3285,0.387031,"5003306",
"879","4114005",Mamborê,14058,8933,63.54389,5125,-1.068605,"4114005",
"880","2933059",Várzea da Roça,14401,6311,43.823346,8090,0.785992,"2933059",
"881","5003454",Deodápolis,11212,9013,80.387085,2199,-0.174606,"5003454",
"882","1600402",Mazagão,13694,7328,53.512487,6366,1.921346,"1600402",
"883","4114104",Mandaguaçu,18236,15752,86.378592,2484,1.154521,"4114104",
"884","3304102",Porciúncula,17084,12955,75.831187,4129,0.984214,"3304102",
"885","2414407",Touros,29147,7821,26.83295,21326,0.637427,"2414407",
"886","3304110",Porto Real,14502,14422,99.448352,80,2.626682,"3304110",
"887","2933158",Várzea Nova,13905,8836,63.545487,5069,-0.253233,"2933158",
"888","1600535",Porto Grande,13781,9091,65.967637,4690,3.21613,"1600535",
"889","4114302",Mandirituba,20209,6788,33.588995,13421,2.044098,"4114302",
"890","3304128",Quatis,11999,10812,90.107509,1187,1.609672,"3304128",
"891","2414506",Umarizal,10640,8553,80.385338,2087,-0.592575,"2414506",
"892","2933208",Vera Cruz,34723,32704,94.18541,2019,2.232749,"2933208",
"893","2414605",Upanema,12710,5902,46.435877,6808,2.097587,"2414605",
"894","5003751",Eldorado,11862,8800,74.186478,3062,1.006394,"5003751",
"895","4114401",Mangueirinha,16961,7167,42.255763,9794,-0.655445,"4114401",
"896","3304151",Quissamã,17283,10072,58.27692,7211,3.402714,"3304151",
"897","5003801",Fátima do Sul,18732,16449,87.8123,2283,-0.285745,"5003801",
"898","4114500",Manoel Ribas,12689,6347,50.019702,6342,-0.417383,"4114500",
"899","1600709",Tartarugalzinho,12256,5999,48.947454,6257,8.065439,"1600709",
"900","4114609",Marechal Cândido Rondon,44382,35300,79.536749,9082,1.136281,"4114609",
"901","1600808",Vitória do Jari,10590,9304,87.856468,1286,3.086827,"1600808",
"902","2414803",Vera Cruz,10309,5020,48.695315,5289,2.756834,"2414803",
"903","5004106",Guia Lopes da Laguna,10164,8379,82.438017,1785,-1.269635,"5004106",
"904","3304409",Rio Claro,17146,15010,87.542284,2136,0.789194,"3304409",
"905","2933455",Wanderley,12892,5954,46.18368,6938,-0.81182,"2933455",
"906","5004304",Iguatemi,14488,10221,70.54804,4267,0.889673,"5004304",
"907","2933505",Wenceslau Guimarães,23609,7011,29.696302,16598,-0.190358,"2933505",
"908","2933604",Xique-Xique,45518,31687,69.614219,13831,0.253632,"2933604",
"909","5004502",Itaporã,18542,12258,66.109373,6284,1.209853,"5004502",
"910","2908507",Conceição do Jacuípe,27442,20824,75.883682,6618,0.667134,"2908507",
"911","5004601",Itaquiraí,16745,7054,42.126008,9691,0.860687,"5004601",
"912","4115101",Mariluz,10433,8511,81.577686,1922,0.189013,"4115101",
"913","3304607",Santa Maria Madalena,10369,5751,55.463401,4618,-0.146555,"3304607",
"914","2500304",Alagoa Grande,27394,16365,59.739359,11029,-0.892883,"2500304",
"915","5004700",Ivinhema,20402,15365,75.311244,5037,-0.840011,"5004700",
"916","3100203",Abaeté,22290,19327,86.707044,2963,-0.044783,"3100203",
"2063","3540200",Pontal,35506,34821,98.070749,685,2.59297,"3540200",
"917","3304706",Santo Antônio de Pádua,39963,30149,75.442284,9814,0.462799,"3304706",
"918","2500403",Alagoa Nova,19160,9218,48.110647,9942,0.443957,"2500403",
"919","3100302",Abre Campo,12773,6563,51.381821,6210,-0.627068,"3100302",
"920","3304755",São Francisco de Itabapoana,44148,22178,50.235571,21970,1.011441,"3304755",
"921","2500502",Alagoinha,12911,8185,63.395554,4726,1.253324,"2500502",
"922","3304805",São Fidélis,37368,28512,76.300578,8856,0.223332,"3304805",
"923","5005004",Jardim,23168,21334,92.083909,1834,0.392078,"5005004",
"924","4115408",Marmeleiro,13124,7722,58.838769,5402,-0.575412,"4115408",
"925","3100500",Açucena,10902,4462,40.92827,6440,-0.746398,"3100500",
"926","3100609",Água Boa,16358,6932,42.376819,9426,-1.195658,"3100609",
"927","3305000",São João da Barra,28809,21601,74.980041,7208,0.571706,"3305000",
"928","2500601",Alhandra,17996,10799,60.00778,7197,1.771949,"2500601",
"929","2500700",São João do Rio do Peixe,17732,6623,37.350553,11109,0.057332,"2500700",
"930","5005202",Ladário,17753,16671,93.905255,1082,2.134641,"5005202",
"931","4115606",Matelândia,14666,10946,74.635211,3720,0.317648,"4115606",
"932","4115705",Matinhos,23176,23035,99.391612,141,-0.606354,"4115705",
"933","3305158",São José do Vale do Rio Preto,19340,8365,43.252327,10975,0.045881,"3305158",
"934","3100906",Águas Formosas,18402,13967,75.899359,4435,0.440051,"3100906",
"935","5005400",Maracaju,30721,25919,84.368998,4802,2.289562,"5005400",
"936","1702208",Araguatins,25518,16993,66.592209,8525,-0.272442,"1702208",
"937","3101003",Águas Vermelhas,12630,8808,69.738717,3822,0.880813,"3101003",
"938","2500809",Araçagi,17340,6358,36.666667,10982,-0.607003,"2500809",
"939","5005608",Miranda,23758,14347,60.38808,9411,0.459923,"5005608",
"940","3101102",Aimorés,24104,18930,78.534683,5174,-0.579589,"3101102",
"941","2500908",Arara,12349,8296,67.179529,4053,0.985146,"2500908",
"942","5005681",Mundo Novo,15683,13873,88.458841,1810,0.012759,"5005681",
"943","4115804",Medianeira,38183,33938,88.882487,4245,0.133908,"4115804",
"944","1702406",Arraias,10509,6918,65.829289,3591,-0.629548,"1702406",
"945","3305406",Sapucaia,16806,12433,73.979531,4373,-0.294854,"3305406",
"946","2501005",Araruna,19136,8916,46.592809,10220,2.047355,"2501005",
"947","5005707",Naviraí,42981,39670,92.296596,3311,2.297676,"5005707",
"948","1702554",Augustinópolis,14671,12122,82.625588,2549,1.782798,"1702554",
"949","2501104",Areia,24892,13960,56.082275,10932,-0.691539,"2501104",
"950","5005806",Nioaque,14986,6959,46.436674,8027,-0.094965,"5005806",
"951","5006002",Nova Alvorada do Sul,11856,7977,67.282389,3879,2.526513,"5006002",
"952","3101508",Além Paraíba,33356,30728,92.121357,2628,-0.108312,"3101508",
"953","3305604",Silva Jardim,21301,16092,75.545749,5209,0.024167,"3305604",
"954","4116059",Missal,10293,5300,51.491305,4993,-0.192811,"4116059",
"955","5006200",Nova Andradina,43239,36317,83.991304,6922,2.906699,"5006200",
"956","1703008",Babaçulândia,10298,5299,51.456594,4999,-0.04293,"1703008",
"957","3305703",Sumidouro,14502,2359,16.266722,12143,0.325331,"3305703",
"958","2501302",Aroeiras,18997,8436,44.407012,10561,-0.387227,"2501302",
"959","4116109",Moreira Sales,12865,9649,75.001943,3216,-0.575069,"4116109",
"960","3305752",Tanguá,28148,25049,88.990337,3099,1.108815,"3305752",
"961","5006309",Paranaíba,38211,33495,87.658004,4716,-0.072692,"5006309",
"962","4116208",Morretes,16113,7523,46.689009,8590,0.765902,"4116208",
"963","3101706",Almenara,36571,29784,81.441579,6787,0.472076,"3101706",
"964","5006358",Paranhos,11017,5402,49.033312,5615,1.085598,"5006358",
"965","2501500",Bananeiras,21601,8445,39.095412,13156,-0.137462,"2501500",
"966","3101904",Alpinópolis,17728,14231,80.274143,3497,0.574646,"3101904",
"967","3102001",Alterosa,13243,9788,73.910745,3455,0.29139,"3102001",
"968","5006903",Porto Murtinho,14113,8982,63.643449,5131,0.833887,"5006903",
"969","2501609",Barra de Santa Rosa,12803,7060,55.143326,5743,-0.356387,"2501609",
"970","5007109",Ribas do Rio Pardo,18957,12784,67.436831,6173,1.809139,"5007109",
"971","4116703",Nova Aurora,11718,8703,74.270353,3015,-2.147378,"4116703",
"972","3306206",Vassouras,32263,21072,65.313207,11191,0.364811,"3306206",
"973","3102100",Alto Rio Doce,12581,4754,37.787139,7827,-1.371578,"3102100",
"974","5007208",Rio Brilhante,26208,20192,77.045177,6016,2.112671,"5007208",
"975","4116901",Nova Esperança,25627,22599,88.184337,3028,-0.056731,"4116901",
"976","3102308",Alvinópolis,15150,10980,72.475248,4170,-0.406327,"3102308",
"977","2501906",Belém,17124,13906,81.207662,3218,0.440641,"2501906",
"978","5007406",Rio Verde de Mato Grosso,18487,15756,85.227457,2731,0.272637,"5007406",
"979","4117057",Nova Laranjeiras,11229,2020,17.989135,9209,-0.584054,"4117057",
"980","3102605",Andradas,34753,26278,75.613616,8475,0.756109,"3102605",
"981","5007695",São Gabriel do Oeste,20339,17532,86.198928,2807,2.750168,"5007695",
"982","4117107",Nova Londrina,12513,10910,87.189323,1603,-0.727306,"4117107",
"983","5007703",Sete Quedas,10523,8679,82.47648,1844,-0.548444,"5007703",
"984","3102803",Andrelândia,11904,9344,78.494624,2560,-0.477961,"3102803",
"985","5007901",Sidrolândia,36915,22732,61.579304,14183,6.675377,"5007901",
"986","3102902",Antônio Carlos,11149,6803,61.018925,4346,0.362701,"3102902",
"987","2502409",Bonito de Santa Fé,10188,6572,64.507263,3616,1.420734,"2502409",
"988","5007935",Sonora,12388,10775,86.979335,1613,3.797774,"5007935",
"989","4117255",Nova Prata do Iguaçu,10307,5843,56.689628,4464,-0.124123,"4117255",
"990","2502508",Boqueirão,15836,11318,71.470068,4518,-0.027934,"2502508",
"991","1705508",Colinas do Tocantins,29180,28133,96.411926,1047,2.058612,"1705508",
"992","5008008",Terenos,12398,6081,49.048234,6317,0.878111,"5008008",
"993","4117305",Ortigueira,24210,8665,35.790995,15545,-0.579925,"4117305",
"994","2502805",Brejo do Cruz,12401,9180,74.026288,3221,0.629565,"2502805",
"995","3103405",Araçuaí,35807,22140,61.831485,13667,0.037559,"3103405",
"996","2503001",Caaporã,19288,15373,79.702406,3915,0.643586,"2503001",
"997","5100201",Água Boa,18621,14978,80.436067,3643,1.5355,"5100201",
"998","4117602",Palmas,40101,36281,90.474053,3820,2.038179,"4117602",
"999","5100250",Alta Floresta,48747,41432,84.993948,7315,0.528235,"5100250",
"1000","4117701",Palmeira,31013,18341,59.139716,12672,0.0767,"4117701",
"1001","1707009",Dianópolis,17283,14600,84.476075,2683,1.635216,"1707009",
"1002","5100300",Alto Araguaia,13503,11442,84.736725,2061,2.435203,"5100300",
"1003","4117800",Palmital,15347,7167,46.699681,8180,-1.415876,"4117800",
"1004","4117909",Palotina,27404,22965,83.801635,4439,0.881565,"4117909",
"1005","2503506",Cacimba de Dentro,17046,8553,50.175994,8493,0.193405,"2503506",
"1006","4118006",Paraíso do Norte,11109,9416,84.760104,1693,1.898033,"4118006",
"1007","3104205",Arcos,34726,31774,91.499165,2952,0.868193,"3104205",
"1008","3104304",Areado,13089,10856,82.939873,2233,0.976794,"3104304",
"1009","1708205",Formoso do Araguaia,18122,12991,71.686348,5131,-0.536187,"1708205",
"1010","5101258",Araputanga,15108,12055,79.792163,3053,1.433826,"5101258",
"1011","3104502",Arinos,17274,10703,61.960171,6571,-0.354662,"3104502",
"1012","3104601",Astolfo Dutra,12474,11225,89.987173,1249,0.790585,"3104601",
"1013","5101407",Aripuanã,18936,11454,60.487959,7482,-5.220246,"5101407",
"1014","1709005",Goiatins,11627,5010,43.089361,6617,0.748031,"1709005",
"1015","3104700",Ataléia,15055,7118,47.279973,7937,-1.51004,"3104700",
"1016","4118808",Peabiru,12939,10699,82.687998,2240,-0.590823,"4118808",
"1017","1709302",Guaraí,21621,19567,90.499977,2054,1.106552,"1709302",
"1018","5101704",Barra do Bugres,31710,25900,81.677704,5810,2.077014,"5101704",
"1019","3104908",Baependi,17848,12602,70.607351,5246,0.262876,"3104908",
"1020","5101902",Brasnorte,13861,7879,56.842941,5982,5.054557,"5101902",
"1021","3105103",Bambuí,21498,17932,83.41241,3566,-0.131543,"3105103",
"1022","2504306",Catolé do Rocha,27417,19774,72.123135,7643,0.411012,"2504306",
"1023","4119103",Piên,11053,3470,31.394192,7583,1.736674,"4119103",
"1024","5102603",Campinápolis,13590,5310,39.072848,8280,1.295559,"5102603",
"1025","2504405",Conceição,17410,10406,59.770247,7004,-0.420347,"2504405",
"1026","5102637",Campo Novo do Parecis,20968,18655,88.968905,2313,2.501369,"5102637",
"1027","3105400",Barão de Cocais,26202,23789,90.790779,2413,1.634419,"3105400",
"1028","5102678",Campo Verde,25747,20112,78.113955,5635,5.913814,"5102678",
"1029","2504603",Conde,19741,12655,64.105162,7086,2.672575,"2504603",
"1030","4119301",Pinhão,28921,14220,49.168424,14701,0.256001,"4119301",
"1031","4119400",Piraí do Sul,23054,15988,69.350221,7066,0.903665,"4119400",
"1032","2504801",Coremas,15112,11116,73.557438,3996,-0.017004,"2504801",
"1033","5102702",Canarana,17040,13601,79.818075,3439,1.44863,"5102702",
"1034","3105905",Barroso,19201,18650,97.130358,551,0.642663,"3105905",
"1035","5102793",Carlinda,12096,4831,39.938823,7265,-0.234,"5102793",
"1036","4119608",Pitanga,34043,18802,55.23015,15241,-0.740472,"4119608",
"1037","5103007",Chapada dos Guimarães,17236,9818,56.962172,7418,1.291735,"5103007",
"1038","2505105",Cuité,20152,12936,64.19214,7216,0.146892,"2505105",
"1039","5103056",Cláudia,10389,8092,77.890076,2297,0.194008,"5103056",
"1040","4119806",Planalto,13585,5228,38.483622,8357,-0.552292,"4119806",
"1041","3106309",Belo Oriente,21236,17783,83.739876,3453,1.213926,"3106309",
"1042","5103205",Colíder,30407,24314,79.961851,6093,1.158785,"5103205",
"1043","4119954",Pontal do Paraná,16540,16370,98.972189,170,2.077209,"4119954",
"1044","3106507",Berilo,13123,3618,27.569915,9505,0.157749,"3106507",
"1045","5103304",Comodoro,17647,11222,63.591545,6425,2.304051,"5103304",
"1046","4120002",Porecatu,14105,11220,79.54626,2885,-1.67993,"4120002",
"1047","5103353",Confresa,21134,9353,44.255702,11781,2.449285,"5103353",
"1048","1713205",Miracema do Tocantins,19608,16651,84.919421,2957,-3.100173,"1713205",
"1049","5103379",Cotriguaçu,13620,5490,40.30837,8130,7.014157,"5103379",
"1050","1713304",Miranorte,11813,10505,88.927453,1308,0.01331,"1713304",
"1051","3106903",Bicas,13584,12583,92.631037,1001,0.860747,"3106903",
"1052","5103502",Diamantino,18188,13470,74.05982,4718,-0.304161,"5103502",
"1053","2505709",Dona Inês,10811,4442,41.087781,6369,0.796482,"2505709",
"1054","3107109",Boa Esperança,37596,31055,82.601873,6541,0.199939,"3107109",
"1055","5103700",Feliz Natal,10199,7500,73.536621,2699,6.031107,"5103700",
"1056","4120507",Primeiro de Maio,10702,9719,90.814801,983,-0.034658,"4120507",
"1057","3107307",Bocaiúva,44356,34758,78.361439,9598,0.509432,"3107307",
"1058","2506004",Esperança,29699,20400,68.689181,9299,0.759985,"2506004",
"1059","4120606",Prudentópolis,48193,21345,44.290665,26848,0.55983,"4120606",
"1060","1714880",Nova Olinda,10477,7261,69.30419,3216,1.584852,"1714880",
"1061","3107406",Bom Despacho,42062,39299,93.431125,2763,0.74118,"3107406",
"1062","2506103",Fagundes,11817,5335,45.146822,6482,-0.090341,"2506103",
"1063","5104104",Guarantã do Norte,30556,21886,71.625867,8670,1.152868,"5104104",
"1064","5104203",Guiratinga,13710,11385,83.041575,2325,1.161893,"5104203",
"1065","3107802",Bom Jesus do Galho,15108,9576,63.383638,5532,-0.968406,"3107802",
"1066","2506400",Gurinhém,13146,5659,43.047315,7487,-0.03906,"2506400",
"1067","4120903",Quedas do Iguaçu,29726,19847,66.766467,9879,1.189791,"4120903",
"1068","3107901",Bom Repouso,10452,5528,52.889399,4924,-0.084455,"3107901",
"1069","4121000",Querência do Norte,11764,7145,60.736144,4619,0.402277,"4121000",
"1070","3108008",Bom Sucesso,17094,13929,81.484731,3165,0.025097,"3108008",
"1071","5104609",Itiquira,11759,3819,32.477251,7940,3.568117,"5104609",
"1072","2506707",Imaculada,11437,4975,43.499169,6462,-0.173658,"2506707",
"1073","5104807",Jaciara,24589,22798,92.716255,1791,0.469408,"5104807",
"1074","4121208",Quitandinha,15860,3329,20.989912,12531,0.541161,"4121208",
"1075","1716109",Paraíso do Tocantins,40085,38159,95.19521,1926,1.495046,"1716109",
"1076","2506806",Ingá,18109,11214,61.92501,6895,0.512053,"2506806",
"1077","1716208",Paranã,10478,4252,40.580263,6226,0.084818,"1716208",
"1078","2506905",Itabaiana,24656,19896,80.694354,4760,-0.315237,"2506905",
"1079","5105002",Jauru,10686,6493,60.761744,4193,-2.50654,"5105002",
"1080","3108305",Borda da Mata,14847,12076,81.336297,2771,0.398864,"3108305",
"1081","2507002",Itaporanga,22369,16272,72.743529,6097,0.822126,"2507002",
"1082","5105101",Juara,31670,26000,82.096621,5670,0.422962,"5105101",
"1083","1716505",Pedro Afonso,10128,8715,86.048578,1413,1.656034,"1716505",
"1084","3108404",Botelhos,14752,10701,72.539317,4051,-0.333476,"3108404",
"1085","2507101",Itapororoca,15952,9941,62.318205,6011,1.24056,"2507101",
"1086","5105150",Juína,38197,32624,85.409849,5573,0.067502,"5105150",
"1087","4121406",Realeza,15756,10562,67.03478,5194,-0.239768,"4121406",
"1088","4121505",Rebouças,13978,7266,51.981686,6712,0.326148,"4121505",
"1089","3108552",Brasilândia de Minas,12755,10868,85.205802,1887,1.524749,"3108552",
"1090","2507309",Jacaraú,13642,7365,53.987685,6277,-0.487756,"2507309",
"1091","5105200",Juscimeira,11822,8696,73.557774,3126,-0.287881,"5105200",
"1092","3108602",Brasília de Minas,30993,18684,60.28458,12309,0.339667,"3108602",
"1093","4121703",Reserva,24184,10749,44.446742,13435,0.122879,"4121703",
"1094","5105259",Lucas do Rio Verde,29955,27458,91.664163,2497,6.468646,"5105259",
"1095","4121802",Ribeirão Claro,10800,7040,65.185185,3760,-0.135506,"4121802",
"1096","3108909",Brasópolis,14330,7637,53.293789,6693,-0.805806,"3108909",
"1097","2507705",Juazeirinho,15847,8127,51.284155,7720,0.9103,"2507705",
"1098","5105507",Vila Bela da Santíssima Trindade,13652,4769,34.932611,8883,1.077821,"5105507",
"1099","4121901",Ribeirão do Pinhal,13307,10829,81.378222,2478,-1.06334,"4121901",
"1100","5105580",Marcelândia,13817,8941,64.71014,4876,-0.635916,"5105580",
"1101","4122008",Rio Azul,13146,4248,32.314012,8898,0.134383,"4122008",
"1102","3109105",Bueno Brandão,10800,5432,50.296296,5368,-0.173394,"3109105",
"1103","2507903",Juripiranga,10204,9417,92.287338,787,0.805121,"2507903",
"1104","5105606",Matupá,14150,10327,72.982332,3823,3.279571,"5105606",
"1105","2508000",Juru,10217,4232,41.421161,5985,0.242837,"2508000",
"1106","5105622",Mirassol d'Oeste,24308,20278,83.421096,4030,0.79517,"5105622",
"1107","4122156",Rio Bonito do Iguaçu,13953,2982,21.371748,10971,0.166973,"4122156",
"1108","1718204",Porto Nacional,44938,38789,86.316703,6149,-0.016837,"1718204",
"1109","5105903",Nobres,14809,11824,79.843339,2985,-0.166734,"5105903",
"1110","3109303",Buritis,21022,14866,70.716392,6156,0.432801,"3109303",
"1111","3500105",Adamantina,33010,31080,94.153287,1930,-0.209,"3500105",
"1112","3109402",Buritizeiro,26053,22721,87.210686,3332,0.08197,"3109402",
"1113","5106109",Nossa Senhora do Livramento,12264,4174,34.034573,8090,0.144104,"5106109",
"1114","4122305",Rio Negro,29710,23112,77.791989,6598,0.490315,"4122305",
"1115","5106158",Nova Bandeirantes,12559,4320,34.397643,8239,8.818093,"5106158",
"1116","3500303",Aguaí,29968,27159,90.626668,2809,0.875027,"3500303",
"1117","3109501",Cabo Verde,13522,7282,53.85298,6240,-0.214722,"3109501",
"1118","4122503",Roncador,12188,7102,58.27043,5086,-1.58682,"4122503",
"1119","3500501",Águas de Lindóia,15616,15502,99.26998,114,-0.514355,"3500501",
"1120","3109709",Cachoeira de Minas,10766,6589,61.201932,4177,0.283162,"3109709",
"1121","2508604",Lucena,10062,8266,82.150666,1796,0.443638,"2508604",
"1122","5106216",Nova Canaã do Norte,11981,6699,55.91353,5282,0.567098,"5106216",
"1123","5106224",Nova Mutum,24041,17398,72.368038,6643,7.157674,"5106224",
"1124","5106232",Nova Olímpia,18913,17369,91.836303,1544,4.194051,"5106232",
"1125","3500709",Agudos,33799,32481,96.100476,1318,0.568518,"3500709",
"1126","2508901",Mamanguape,40093,32617,81.353353,7476,0.479767,"2508901",
"1127","2509008",Manaíra,10976,5815,52.979227,5161,0.672401,"2509008",
"1128","4123006",Salto do Lontra,12372,5997,48.472357,6375,-0.436819,"4123006",
"1129","5106257",Nova Xavantina,18576,14671,78.978252,3905,0.585649,"5106257",
"1130","3110301",Caldas,13802,7785,56.404869,6017,1.120923,"3110301",
"1131","2509107",Mari,20513,17098,83.352021,3415,-0.104029,"2509107",
"1132","3501004",Altinópolis,15072,13240,87.845011,1832,-0.381766,"3501004",
"1133","3110509",Camanducaia,19378,14086,72.69068,5292,-0.82642,"3110509",
"1134","2509206",Massaranduba,12480,4232,33.910256,8248,0.92994,"2509206",
"1135","5106299",Paranaíta,11498,6336,55.105236,5162,1.649241,"5106299",
"1136","3110608",Cambuí,24879,19933,80.11978,4946,1.147658,"3110608",
"1137","5106307",Paranatinga,19844,14578,73.463011,5266,3.744216,"5106307",
"1138","4123501",Santa Helena,22364,10296,46.038276,12068,1.257364,"4123501",
"1139","3110707",Cambuquira,12394,10087,81.386155,2307,-0.164886,"3110707",
"1140","5106372",Pedra Preta,15536,11096,71.421215,4440,1.907706,"5106372",
"1141","3501301",Álvares Machado,22811,20646,90.508965,2165,0.094294,"3501301",
"1142","5106422",Peixoto de Azevedo,28720,19690,68.558496,9030,1.344894,"5106422",
"1143","3110905",Campanha,15044,12887,85.662058,2157,0.932122,"3110905",
"1144","4123808",Santa Izabel do Oeste,11368,6311,55.515482,5057,-0.423759,"4123808",
"1145","1720200",São Miguel do Tocantins,10206,2360,23.123653,7846,2.671608,"1720200",
"1146","3111002",Campestre,20108,10801,53.714939,9307,-0.312214,"3111002",
"1147","2509404",Mogeiro,12294,5279,42.939645,7015,-1.043817,"2509404",
"1148","5106505",Poconé,30673,22200,72.376357,8473,-0.046488,"5106505",
"1149","3111101",Campina Verde,18027,13253,73.517502,4774,-0.822565,"3111101",
"1150","4123857",Santa Maria do Oeste,11506,2864,24.891361,8642,-2.400221,"4123857",
"1151","3501707",Américo Brasiliense,30952,30509,98.568752,443,1.294526,"3501707",
"1152","4123907",Santa Mariana,11960,7949,66.463211,4011,-1.684188,"4123907",
"1153","2509701",Monteiro,29775,18665,62.686818,11110,1.044072,"2509701",
"1154","5106752",Pontes e Lacerda,37739,31286,82.900978,6453,-1.851013,"5106752",
"1155","3111309",Campo do Meio,11408,10080,88.359046,1328,-0.035014,"3111309",
"1156","2509909",Natuba,10210,3059,29.960823,7151,-0.483044,"2509909",
"1157","3111507",Campos Altos,13122,12339,94.032922,783,0.334297,"3111507",
"1158","4124053",Santa Terezinha de Itaipu,19488,17048,87.479475,2440,0.84914,"4124053",
"1159","3502200",Angatuba,21458,15231,70.98052,6227,1.527954,"3502200",
"1160","1720903",Taguatinga,14032,9656,68.814139,4376,0.910907,"1720903",
"1161","3111606",Campos Gerais,26819,18751,69.91685,8068,0.148966,"3111606",
"1162","4124103",Santo Antônio da Platina,40262,34005,84.459292,6257,0.113703,"4124103",
"1163","5107008",Poxoréo,17204,12098,70.320856,5106,-2.14927,"5107008",
"1164","3111804",Canápolis,11182,9903,88.561975,1279,0.721778,"3111804",
"1165","5107040",Primavera do Leste,42802,40804,95.331994,1998,1.023586,"5107040",
"1166","4124400",Santo Antônio do Sudoeste,18521,12168,65.698396,6353,0.512479,"4124400",
"1167","3502507",Aparecida,35483,35048,98.774061,435,0.235309,"3502507",
"1168","5107065",Querência,10621,4882,45.96554,5739,5.556404,"5107065",
"1169","3112000",Candeias,15393,10220,66.393815,5173,0.896242,"3112000",
"1170","5107107",São José dos Quatro Marcos,18848,14141,75.026528,4707,-0.624562,"5107107",
"1171","3502705",Apiaí,25112,18164,72.331953,6948,-1.114784,"3502705",
"1172","1721208",Tocantinópolis,21183,17268,81.518199,3915,-1.031108,"1721208",
"1173","4124707",São Jerônimo da Serra,11524,5865,50.893787,5659,-0.277064,"4124707",
"1174","4124806",São João,10833,6324,58.377181,4509,-0.483706,"4124806",
"1175","3112307",Capelinha,32850,22828,69.491629,10022,0.724621,"3112307",
"1176","4125001",São João do Ivaí,11774,8920,75.760149,2854,-1.615664,"4125001",
"1177","1722107",Xambioá,10834,8815,81.364224,2019,-1.609328,"1722107",
"1178","2510907",Paulista,11601,5183,44.677183,6418,0.419477,"2510907",
"1179","4125100",São João do Triunfo,13509,3792,28.070175,9717,1.210252,"4125100",
"1180","3112604",Capinópolis,15234,14078,92.411711,1156,0.804551,"3112604",
"1181","2100154",Água Doce do Maranhão,11811,2987,25.289984,8824,2.848328,"2100154",
"1182","2511202",Pedras de Fogo,26227,15364,58.580852,10863,0.200964,"2511202",
"1183","5107305",São José do Rio Claro,17138,13419,78.299685,3719,4.327469,"5107305",
"1184","2100204",Alcântara,21212,5871,27.67773,15341,-0.053091,"2100204",
"1185","3112703",Capitão Enéas,13916,11348,81.546421,2568,0.852688,"3112703",
"1186","2511301",Piancó,15812,11043,69.839363,4769,0.8794,"2511301",
"1187","2100303",Aldeias Altas,21589,10766,49.867988,10823,1.974846,"2100303",
"1188","2511400",Picuí,18669,11193,59.955006,7476,0.605931,"2511400",
"1189","2511509",Pilar,11234,7610,67.740787,3624,1.284298,"2511509",
"1190","2100436",Alto Alegre do Maranhão,21930,14933,68.093935,6997,1.208037,"2100436",
"1191","3113008",Caraí,21477,6856,31.922522,14621,0.334348,"3113008",
"1192","5107701",Rosário Oeste,17745,10335,58.241758,7410,-0.78769,"5107701",
"1193","3503604",Areiópolis,10562,9525,90.181784,1037,0.365053,"3503604",
"1194","2100477",Alto Alegre do Pindaré,31943,9395,29.411765,22548,0.815781,"2100477",
"1195","4125605",São Mateus do Sul,39019,23977,61.44955,15042,0.930702,"4125605",
"1196","2100501",Alto Parnaíba,10177,6212,61.039599,3965,0.004212,"2100501",
"1197","3113206",Carandaí,22192,16935,76.311283,5257,0.752803,"3113206",
"1198","2511806",Pirpirituba,10211,7744,75.839781,2467,0.018201,"2511806",
"1199","4125704",São Miguel do Iguaçu,25257,14759,58.435285,10498,0.47555,"4125704",
"1200","3503802",Artur Nogueira,39402,36224,91.93442,3178,2.5104,"3503802",
"1201","3113305",Carangola,31828,25194,79.156717,6634,-0.041673,"3113305",
"1202","2511905",Pitimbu,15975,9439,59.086072,6536,1.97927,"2511905",
"1203","5107800",Santo Antônio do Leverger,19032,6317,33.191467,12715,3.037859,"5107800",
"1204","2100600",Amarante do Maranhão,35540,14157,39.83399,21383,1.835155,"2100600",
"1205","2512002",Pocinhos,15939,8809,55.266955,7130,0.986995,"2512002",
"1206","5107859",São Félix do Araguaia,10540,5990,56.83112,4550,-0.197669,"5107859",
"1207","2100709",Anajatuba,23912,6448,26.96554,17464,0.570811,"2100709",
"1208","3113503",Carbonita,10108,7116,70.399683,2992,1.725809,"3113503",
"1209","5107875",Sapezal,12887,10465,81.205866,2422,7.307053,"5107875",
"1210","2100808",Anapurus,12552,6096,48.565966,6456,2.893643,"2100808",
"1211","3113701",Carlos Chagas,20641,13128,63.60157,7513,-0.902903,"3113701",
"1212","2512101",Pombal,31432,24237,77.109315,7195,-0.235022,"2512101",
"1213","3504206",Auriflama,13688,12595,92.014904,1093,0.183988,"3504206",
"1214","5107941",Tabaporã,10212,5051,49.461418,5161,-0.851553,"5107941",
"1215","3113909",Carmo da Cachoeira,11547,8433,73.031956,3114,-0.065399,"3113909",
"1216","2100907",Araioses,37616,10012,26.616333,27604,1.073879,"2100907",
"1217","2512309",Princesa Isabel,19254,13072,67.892386,6182,0.782984,"2512309",
"1218","2100956",Arame,27095,10978,40.5167,16117,-1.370537,"2100956",
"1219","3114006",Carmo da Mata,10899,8355,76.658409,2544,0.67175,"3114006",
"1220","2512408",Puxinanã,12843,3857,30.031924,8986,0.997468,"2512408",
"1221","3114105",Carmo de Minas,13593,8777,64.569999,4816,1.152776,"3114105",
"1222","2101004",Arari,27673,16383,59.20211,11290,0.693564,"2101004",
"1223","5108055",Terra Nova do Norte,14553,5773,39.668797,8780,0.872922,"5108055",
"1224","4126306",Sengés,19199,14898,77.597792,4301,1.104577,"4126306",
"1225","3114204",Carmo do Cajuru,18845,16102,85.444415,2743,1.349617,"3114204",
"1226","2101103",Axixá,14233,1830,12.857444,12403,4.96021,"2101103",
"1227","3114303",Carmo do Paranaíba,30426,25380,83.4155,5046,0.461979,"3114303",
"1228","2512705",Remígio,16693,11656,69.825675,5037,1.622872,"2512705",
"1229","3114402",Carmo do Rio Claro,19379,13759,70.999536,5620,-0.257549,"3114402",
"1230","2101251",Bacabeira,14537,3150,21.668845,11387,4.734358,"2101251",
"1231","4126504",Sertanópolis,15390,13426,87.238467,1964,0.227622,"4126504",
"1232","2101301",Bacuri,15500,7755,50.032258,7745,-0.028539,"2101301",
"1233","3114501",Carmópolis de Minas,15627,10497,67.172202,5130,1.227322,"3114501",
"1234","3504909",Bananal,10171,7960,78.261725,2211,0.66039,"3504909",
"1235","4126603",Siqueira Campos,16535,12068,72.984578,4467,0.470972,"4126603",
"1236","5108600",Vila Rica,18815,13597,72.266808,5218,2.729058,"5108600",
"1237","4126678",Tamarana,10438,5331,51.073002,5107,1.033703,"4126678",
"1238","3505203",Bariri,30853,29328,95.057207,1525,1.280433,"3505203",
"1239","2101509",Barão de Grajaú,16542,8674,52.436223,7868,1.075056,"2101509",
"1240","3505302",Barra Bonita,34948,34226,97.934073,722,-0.218407,"3505302",
"1241","4126801",Tapejara,14409,12507,86.799917,1902,1.347791,"4126801",
"1242","2101707",Barreirinhas,47466,17680,37.247714,29786,2.59662,"2101707",
"1243","2512903",Rio Tinto,22982,12919,56.213558,10063,0.424204,"2512903",
"1244","2513109",Salgado de São Félix,12440,5199,41.792605,7241,0.460836,"2513109",
"1245","4107009",Curiúva,14213,9093,63.976641,5120,1.389851,"4107009",
"1246","3505609",Barrinha,25565,25203,98.584002,362,0.782796,"3505609",
"1247","4127205",Terra Boa,14547,12001,82.49811,2546,-0.090997,"4127205",
"1248","5200100",Abadiânia,12537,7741,61.745234,4796,1.301538,"5200100",
"1249","2101905",Bequimão,20701,5516,26.646056,15185,0.710561,"2101905",
"1250","4127304",Terra Rica,14268,11331,79.415475,2937,0.480696,"4127304",
"1251","3505807",Bastos,20578,17516,85.120031,3062,-0.00694,"3505807",
"1252","5200134",Acreúna,18470,16343,88.484028,2127,0.131402,"5200134",
"1253","4127403",Terra Roxa,16083,12010,74.675123,4073,-0.191278,"4127403",
"1254","4127502",Tibagi,18619,11136,59.809872,7483,0.142756,"4127502",
"1255","2102002",Bom Jardim,37531,14637,38.99976,22894,1.221136,"2102002",
"1256","3115508",Caxambu,20935,20359,97.248627,576,-0.789248,"3115508",
"1257","2513406",Santa Luzia,14209,12852,90.449715,1357,0.199648,"2513406",
"1258","4127601",Tijucas do Sul,13072,1803,13.79284,11269,0.920361,"4127601",
"1259","2102036",Bom Jesus das Selvas,22695,11242,49.53514,11453,4.618637,"2102036",
"1260","2102077",Bom Lugar,12814,2774,21.648197,10040,1.514774,"2102077",
"1261","3506300",Bernardino de Campos,10430,9302,89.185043,1128,-0.391018,"3506300",
"1262","5200308",Alexânia,19902,16560,83.207718,3342,-0.10365,"5200308",
"1263","2102101",Brejo,31001,11484,37.043966,19517,1.719776,"2102101",
"1264","4127858",Três Barras do Paraná,11605,5265,45.368376,6340,-0.26431,"4127858",
"1265","2102200",Buriti,25223,8091,32.077865,17132,0.637253,"2102200",
"1266","2102309",Buriti Bravo,22224,16010,72.039237,6214,0.510364,"2102309",
"1267","3116100",Chapada do Norte,15427,5185,33.609905,10242,0.188469,"3116100",
"1268","3506607",Biritiba-Mirim,27445,23750,86.53671,3695,1.544454,"3506607",
"1269","3116159",Chapada Gaúcha,10237,5308,51.851128,4929,5.010818,"3116159",
"1270","2513901",São Bento,29052,22301,76.762357,6751,1.473235,"2513901",
"1271","4127965",Turvo,13987,4729,33.809966,9258,-0.542625,"4127965",
"1272","3506706",Boa Esperança do Sul,13141,11668,88.790807,1473,0.633217,"3506706",
"1273","2102358",Buritirana,12553,4181,33.306779,8372,-1.366321,"2102358",
"1274","4128005",Ubiratã,21141,17405,82.328177,3736,-0.944452,"4128005",
"1275","3506805",Bocaina,10244,9217,89.974619,1027,1.171442,"3506805",
"1276","2102507",Cajari,12753,4058,31.819964,8695,-0.709772,"2102507",
"1277","2102556",Campestre do Maranhão,12144,9483,78.087945,2661,0.755177,"2102556",
"1278","3116605",Cláudio,24465,19176,78.381361,5289,1.189171,"3116605",
"1279","4128401",Uraí,11459,9165,79.980801,2294,-0.509329,"4128401",
"1280","5201306",Anicuns,17633,15156,85.952475,2477,-0.876634,"5201306",
"1281","2102606",Cândido Mendes,18638,10971,58.863612,7667,1.697825,"2102606",
"1282","4128500",Wenceslau Braz,18598,14579,78.390149,4019,-0.717152,"4128500",
"1283","2102705",Cantanhede,18781,11805,62.856078,6976,0.839892,"2102705",
"1284","4128534",Ventania,10261,6758,65.861027,3503,3.575483,"4128534",
"1285","2102754",Capinzal do Norte,10353,4434,42.828166,5919,-0.25946,"2102754",
"1286","3507407",Borborema,13701,11988,87.497263,1713,0.541208,"3507407",
"1287","2102804",Carolina,24346,15068,61.89107,9278,0.21006,"2102804",
"1288","3117108",Conceição da Aparecida,10069,5876,58.357334,4193,1.030053,"3117108",
"1289","2102903",Carutapera,20205,13821,68.40386,6384,1.170787,"2102903",
"1290","5201702",Aragarças,16668,16302,97.804176,366,0.065308,"5201702",
"1291","2514503",São José de Piranhas,18878,9774,51.774552,9104,0.78216,"2514503",
"1292","3117306",Conceição das Alagoas,20161,18881,93.651109,1280,2.332532,"3117306",
"1293","3117504",Conceição do Mato Dentro,18006,11585,64.339665,6421,-0.490846,"3117504",
"1294","3507803",Brodowski,18980,18454,97.228662,526,1.468235,"3507803",
"1295","2103174",Centro Novo do Maranhão,14953,4515,30.19461,10438,0.38712,"2103174",
"1296","3507902",Brotas,20881,18774,89.909487,2107,1.444893,"3507902",
"1297","3117702",Conceição do Rio Verde,12612,10922,86.600063,1690,0.390002,"3117702",
"1298","3508009",Buri,17499,13748,78.564489,3751,-0.10568,"3508009",
"1299","2103257",Cidelândia,12380,5059,40.864297,7321,0.668334,"2103257",
"1300","3117801",Conceição dos Ouros,10134,7598,74.975331,2536,1.824904,"3117801",
"1301","3508108",Buritama,14622,13680,93.557653,942,0.773739,"3508108",
"1302","2103406",Coelho Neto,43955,36845,83.824366,7110,0.579019,"2103406",
"1303","2515104",São Sebastião de Lagoa de Roça,10904,4285,39.297506,6619,1.206477,"2515104",
"1304","4200101",Abelardo Luz,16332,7714,47.232427,8618,-0.094113,"4200101",
"1305","5203302",Bela Vista de Goiás,20488,14193,69.274697,6295,0.924366,"5203302",
"1306","2103505",Colinas,35499,22576,63.596158,12923,-0.121742,"2103505",
"1307","3118007",Congonhas,43499,42130,96.852801,1369,0.759173,"3118007",
"1308","2103554",Conceição do Lago-Açu,14059,6513,46.326197,7546,3.875007,"2103554",
"1309","2515302",Sapé,46172,35332,76.522568,10840,-0.360159,"2515302",
"1310","5203500",Bom Jesus de Goiás,19225,17925,93.237971,1300,2.424465,"5203500",
"1311","3508603",Cachoeira Paulista,31233,25453,81.493933,5780,1.992074,"3508603",
"1312","2103703",Cururupu,33886,22255,65.67609,11631,0.058738,"2103703",
"1313","2515500",Serra Branca,12364,8593,69.500162,3771,0.103258,"2515500",
"1314","2103752",Davinópolis,11751,9708,82.614246,2043,-0.621295,"2103752",
"1315","3508702",Caconde,18391,12219,66.440107,6172,0.010102,"3508702",
"1316","3118403",Conselheiro Pena,21684,17090,78.813872,4594,-0.032897,"3118403",
"1317","3508801",Cafelândia,16015,13750,85.857009,2265,0.199613,"3508801",
"1318","2103802",Dom Pedro,21438,14378,67.067823,7060,-0.340496,"2103802",
"1319","2103901",Duque Bacelar,10336,4926,47.658669,5410,1.345272,"2103901",
"1320","2104008",Esperantinópolis,18564,9443,50.86727,9121,-1.894796,"2104008",
"1321","2104057",Estreito,26323,18588,70.615051,7735,1.990946,"2104057",
"1322","3118809",Coração de Jesus,26025,14138,54.324688,11887,0.163546,"3118809",
"1323","3509254",Cajati,28171,19932,70.753612,8239,-0.524333,"3509254",
"1324","2516003",Solânea,27189,18960,69.734084,8229,-1.700815,"2516003",
"1325","2104099",Formosa da Serra Negra,16633,4814,28.942464,11819,2.72354,"2104099",
"1326","3119104",Corinto,22591,20127,89.093002,2464,-1.178674,"3119104",
"1327","2516102",Soledade,13076,9471,72.430407,3605,1.160993,"2516102",
"1328","3509403",Cajuru,22589,19949,88.312896,2640,1.201684,"3509403",
"1329","2104107",Fortaleza dos Nogueiras,11536,6778,58.755201,4758,0.294452,"2104107",
"1330","3119203",Coroaci,10748,5167,48.07406,5581,-0.071569,"3119203",
"1331","3119302",Coromandel,27109,21162,78.062636,5947,-0.179457,"3119302",
"1332","2104206",Fortuna,14463,8961,61.9581,5502,-0.130684,"2104206",
"1333","5204300",Caçu,10754,8445,78.528919,2309,0.240074,"5204300",
"1334","2104305",Godofredo Viana,10350,7577,73.207729,2773,5.758769,"2104305",
"1335","2516300",Sumé,16353,11861,72.531034,4492,1.207671,"2516300",
"1336","5204409",Caiapônia,15382,11404,74.138604,3978,0.676405,"5204409",
"1337","2104404",Gonçalves Dias,16420,7393,45.024361,9027,-0.317828,"2104404",
"1338","3509700",Campos do Jordão,44212,43950,99.407401,262,-0.012918,"3509700",
"1339","2516508",Taperoá,14657,8522,58.142867,6135,1.39868,"2516508",
"1340","2104552",Governador Edison Lobão,14049,5645,40.180796,8404,3.70431,"2104552",
"1341","2516607",Tavares,13997,6144,43.89512,7853,0.428779,"2516607",
"1342","3509908",Cananéia,11924,9863,82.715532,2061,-0.440221,"3509908",
"1343","2104602",Governador Eugênio Barros,15829,4358,27.531746,11471,1.132621,"2104602",
"1344","2516706",Teixeira,13628,8872,65.101262,4756,1.891149,"2516706",
"1345","3510005",Cândido Mota,29503,27657,93.743009,1846,0.108448,"3510005",
"1346","2104651",Governador Newton Bello,11164,3779,33.849875,7385,-0.793182,"2104651",
"1347","2104677",Governador Nunes Freire,23935,14635,61.144767,9300,-1.132278,"2104677",
"1348","2516904",Uiraúna,14388,9933,69.036697,4455,0.722404,"2516904",
"1349","5204904",Campos Belos,18148,15844,87.304386,2304,0.898096,"5204904",
"1350","3510203",Capão Bonito,45067,37506,83.222757,7561,-0.516929,"3510203",
"1351","3510302",Capela do Alto,15924,13062,82.027129,2862,1.602433,"3510302",
"1352","3120201",Cristais,10521,8091,76.903336,2430,1.441556,"3120201",
"1353","2104909",Guimarães,12377,5114,41.318575,7263,-0.301054,"2104909",
"1354","3510401",Capivari,43656,35963,82.378138,7693,0.737257,"3510401",
"1355","2105005",Humberto de Campos,24243,7734,31.901992,16509,1.889317,"2105005",
"1356","2105104",Icatu,24363,5695,23.375611,18668,1.80938,"2105104",
"1357","3120508",Cristina,10901,5933,54.426199,4968,0.759029,"3120508",
"1358","2105153",Igarapé do Meio,11689,5225,44.700145,6464,2.487423,"2105153",
"1359","2600104",Afogados da Ingazeira,33943,25385,74.787143,8558,0.437261,"2600104",
"1360","3510708",Cardoso,11283,10217,90.552158,1066,-0.401177,"3510708",
"1361","2105203",Igarapé Grande,10671,6001,56.236529,4670,1.284463,"2105203",
"1362","2600203",Afrânio,16451,4931,29.973862,11520,1.314322,"2600203",
"1363","5205406",Ceres,18591,17687,95.137432,904,-2.508292,"5205406",
"1364","3510807",Casa Branca,24863,21962,88.33206,2901,-1.066008,"3510807",
"1365","2600302",Agrestina,21369,15522,72.637933,5847,0.924398,"2600302",
"1366","4202107",Barra Velha,18522,17463,94.282475,1059,2.548879,"4202107",
"1367","2105351",Itaipava do Grajaú,13184,3557,26.979672,9627,-0.168972,"2105351",
"1368","3120805",Cruzília,14601,13144,90.021231,1457,0.845856,"3120805",
"1369","2600401",Água Preta,29447,16934,57.506707,12513,0.452461,"2600401",
"1370","3511003",Castilho,15391,12280,79.786888,3111,0.418092,"3511003",
"1371","2600500",Águas Belas,37624,22637,60.166383,14987,0.378921,"2600500",
"1372","2105427",Itinga do Maranhão,24861,17951,72.205462,6910,1.037579,"2105427",
"1373","2600609",Alagoinha,13979,8090,57.872523,5889,1.569786,"2600609",
"1374","5205513",Cocalzinho de Goiás,14156,6084,42.978242,8072,-0.465516,"5205513",
"1375","2600708",Aliança,34647,17106,49.37224,17541,-1.006357,"2600708",
"1376","2105476",Jenipapo dos Vieiras,14763,2404,16.283953,12359,5.544076,"2105476",
"1377","2600807",Altinho,21704,12045,55.496683,9659,-0.277938,"2600807",
"1378","3511409",Cerqueira César,16157,14436,89.34827,1721,0.929277,"3511409",
"1379","2105500",João Lisboa,19923,14843,74.501832,5080,-2.966402,"2105500",
"1380","2600906",Amaraji,20133,15568,77.325784,4565,-0.80771,"2600906",
"1381","3511508",Cerquilho,34670,33045,95.312951,1625,2.329773,"3511508",
"1382","2105609",Joselândia,15555,4881,31.378978,10674,0.900377,"2105609",
"1383","4202453",Bombinhas,12352,12352,100,0,5.106951,"4202453",
"1384","3511607",Cesário Lange,13959,9319,66.759797,4640,1.152532,"3511607",
"1385","2601052",Araçoiaba,16223,12698,78.27159,3525,1.022414,"2601052",
"1386","5206206",Cristalina,36253,30155,83.179323,6098,0.871715,"5206206",
"1387","3511706",Charqueada,14340,13023,90.8159,1317,1.370179,"3511706",
"1388","2105708",Lago da Pedra,42562,26198,61.552559,16364,0.745743,"2105708",
"1389","5206404",Crixás,14486,11456,79.083253,3030,-0.183067,"5206404",
"1390","3512001",Colina,16930,15616,92.23863,1314,0.226492,"3512001",
"1391","2105906",Lago Verde,14553,5324,36.583522,9229,1.58281,"2105906",
"1392","2601300",Barra de Guabiraba,12681,10889,85.868622,1792,2.133445,"2601300",
"1393","3121605",Diamantina,44395,38955,87.746368,5440,0.04384,"3121605",
"1394","2105922",Lagoa do Mato,10213,4110,40.242828,6103,1.121529,"2105922",
"1395","2601409",Barreiros,41496,34865,84.020147,6631,0.838894,"2601409",
"1396","3512209",Conchal,23313,21612,92.703642,1701,0.396556,"3512209",
"1397","4202800",Braço do Norte,27627,22481,81.373294,5146,1.552924,"4202800",
"1398","3512308",Conchas,15358,11905,77.516604,3453,0.42959,"3512308",
"1399","3121803",Dionísio,10210,7763,76.033301,2447,0.026613,"3121803",
"1400","2601607",Belém de São Francisco,20404,12844,62.948441,7560,0.137986,"2601607",
"1401","3512407",Cordeirópolis,19100,17193,90.015707,1907,1.182666,"3512407",
"1402","2106003",Lima Campos,11353,6617,58.284154,4736,0.784048,"2106003",
"1403","3122009",Divino,19078,9707,50.880595,9371,0.502671,"3122009",
"1404","2601805",Betânia,11504,3334,28.981224,8170,0.249592,"2601805",
"1405","2106102",Loreto,10320,5293,51.28876,5027,0.416602,"2106102",
"1406","2602001",Bodocó,33315,10500,31.517335,22815,0.698336,"2602001",
"1407","2106300",Magalhães de Almeida,14173,7290,51.435829,6883,1.218439,"2106300",
"1408","2602100",Bom Conselho,43120,26448,61.335807,16672,0.347682,"2602100",
"1409","5207402",Edéia,10199,8464,82.988528,1735,-0.033572,"5207402",
"1410","2106326",Maracaçumé,17511,14461,82.582377,3050,2.366899,"2106326",
"1411","2602209",Bom Jardim,38825,14460,37.244044,24365,0.685124,"2602209",
"1412","2602308",Bonito,38912,25260,64.915707,13652,0.434042,"2602308",
"1413","3513108",Cravinhos,29248,28489,97.404951,759,0.415644,"3513108",
"1414","2106375",Maranhãozinho,11855,7667,64.673134,4188,4.964666,"2106375",
"1415","4203303",Campo Alegre,11362,6628,58.3348,4734,-0.337392,"4203303",
"1416","2106409",Mata Roma,13796,6294,45.621919,7502,2.258906,"2106409",
"1417","5207808",Firminópolis,10242,8181,79.876977,2061,0.473309,"5207808",
"1418","2106508",Matinha,20396,7819,38.335948,12577,0.843757,"2106508",
"1419","2602605",Brejo da Madre de Deus,40214,29780,74.053812,10434,0.771025,"2602605",
"1420","2106607",Matões,28253,11748,41.581425,16505,0.955773,"2106607",
"1421","2602704",Buenos Aires,12933,7721,59.699992,5212,1.066972,"2602704",
"1422","4203600",Campos Novos,28368,22685,79.966864,5683,-0.180484,"4203600",
"1423","2106631",Matões do Norte,10568,3326,31.472369,7242,5.151622,"2106631",
"1424","2602803",Buíque,49523,18549,37.455324,30974,1.647917,"2602803",
"1425","3513603",Cunha,22860,11856,51.863517,11004,-0.142912,"3513603",
"1426","3513702",Descalvado,29344,23711,80.803571,5633,0.207646,"3513702",
"1427","2106706",Mirador,19377,7935,40.950612,11442,-0.384038,"2106706",
"1428","2603009",Cabrobó,28749,17640,61.358656,11109,1.039725,"2603009",
"1429","4203907",Capinzal,18421,15372,83.448238,3049,-1.136188,"4203907",
"1430","5208400",Goianápolis,11123,10078,90.605053,1045,0.594406,"5208400",
"1431","2106755",Miranda do Norte,17703,14915,84.251257,2788,1.344491,"2106755",
"1432","2603108",Cachoeirinha,17314,13083,75.563128,4231,0.226464,"2603108",
"1433","4203956",Capivari de Baixo,20047,18807,93.814536,1240,1.106317,"4203956",
"1434","2106805",Mirinzal,13733,8684,63.234545,5049,0.781147,"2106805",
"1435","2603207",Caetés,25152,6831,27.158874,18321,0.590185,"2603207",
"1436","3513900",Divinolândia,11063,7501,67.802585,3562,-1.17353,"3513900",
"1437","3123205",Dores do Indaiá,13934,12923,92.744366,1011,-0.45699,"3123205",
"1438","2106904",Monção,27503,10303,37.461368,17200,0.782273,"2106904",
"1439","2603306",Calçado,11278,3675,32.585565,7603,-0.534337,"2603306",
"1440","3514106",Dois Córregos,24212,23000,94.994218,1212,1.039014,"3514106",
"1441","2107100",Morros,17045,5297,31.076562,11748,2.242582,"2107100",
"1442","5208905",Goiás,24163,17353,71.816414,6810,-1.635744,"5208905",
"1443","2603504",Camocim de São Félix,15761,13235,83.973098,2526,0.599661,"2603504",
"1444","5209101",Goiatuba,31066,28422,91.489088,2644,-0.029396,"5209101",
"1445","3514403",Dracena,40854,38013,93.045969,2841,0.124402,"3514403",
"1446","3123601",Elói Mendes,24091,19572,81.241958,4519,1.340445,"3123601",
"1447","2603702",Canhotinho,23217,13235,57.005642,9982,-1.006132,"2603702",
"1448","5209200",Guapó,13415,10109,75.355945,3306,-0.468185,"5209200",
"1449","3514502",Duartina,12311,10728,87.141581,1583,-0.188871,"3514502",
"1450","4204251",Cocal do Sul,14517,12141,83.632982,2376,0.803619,"4204251",
"1451","2107357",Nova Olinda do Maranhão,17080,10928,63.981265,6152,1.247698,"2107357",
"1452","3123700",Engenheiro Caldas,10295,8478,82.350656,1817,1.389608,"3123700",
"1453","2603801",Capoeiras,19300,5714,29.606218,13586,-0.188066,"2603801",
"1454","2107407",Olho d'Água das Cunhãs,17327,8791,50.735846,8536,2.702094,"2107407",
"1455","2603900",Carnaíba,18316,7059,38.540074,11257,0.49316,"2603900",
"1456","2107456",Olinda Nova do Maranhão,12054,5050,41.894807,7004,2.518223,"2107456",
"1457","2603926",Carnaubeira da Penha,11650,1660,14.248927,9990,1.629067,"2603926",
"1458","4204400",Coronel Freitas,10200,5109,50.088235,5091,-0.460584,"4204400",
"1459","3514809",Eldorado,13813,6527,47.252588,7286,-0.327649,"3514809",
"1460","3123908",Entre Rios de Minas,13823,9334,67.525139,4489,0.755029,"3123908",
"1461","3514908",Elias Fausto,14502,11748,81.009516,2754,0.619934,"3514908",
"1462","2107605",Palmeirândia,18074,3416,18.900077,14658,0.657165,"2107605",
"1463","3124005",Ervália,17930,9030,50.362521,8900,0.748555,"3124005",
"1464","5209705",Hidrolândia,13860,9489,68.463203,4371,0.824294,"5209705",
"1465","4204509",Corupá,12706,9586,75.444672,3120,1.005012,"4204509",
"1466","2107704",Paraibano,19433,14954,76.951577,4479,1.218002,"2107704",
"1467","2604155",Casinhas,14096,1543,10.946368,12553,0.785199,"2604155",
"1468","4204558",Correia Pinto,14747,12109,82.111616,2638,-2.031956,"4204558",
"1469","2107803",Parnarama,34802,12198,35.04971,22604,0.996202,"2107803",
"1470","3124203",Espera Feliz,20767,12476,60.076082,8291,0.165499,"3124203",
"1471","2604205",Catende,33044,25287,76.525239,7757,0.7974,"2604205",
"1472","5209903",Iaciara,12630,8997,71.235154,3633,1.608728,"5209903",
"1473","2107902",Passagem Franca,17060,9610,56.330598,7450,2.034146,"2107902",
"1474","3124302",Espinosa,31233,17261,55.265264,13972,0.117182,"3124302",
"1475","2604304",Cedro,10224,5772,56.455399,4452,0.97749,"2604304",
"1476","4204707",Cunha Porã,10543,6156,58.389453,4387,0.432867,"4204707",
"1477","2108009",Pastos Bons,17504,11174,63.836837,6330,1.789733,"2108009",
"1478","2604403",Chã de Alegria,11613,8454,72.797727,3159,0.644926,"2604403",
"1479","5209952",Indiara,12613,10328,81.883771,2285,0.936839,"5209952",
"1480","3124500",Estiva,10903,4712,43.217463,6191,0.724134,"3124500",
"1481","2108058",Paulino Neves,12707,3244,25.529236,9463,1.403293,"2108058",
"1482","2604502",Chã Grande,17534,11790,67.240789,5744,-0.691728,"2604502",
"1483","4204806",Curitibanos,37264,34091,91.485079,3173,0.469897,"4204806",
"1484","5210000",Inhumas,44547,41988,94.255505,2559,0.210204,"5210000",
"1485","3515152",Engenheiro Coelho,12495,9227,73.845538,3268,3.184643,"3515152",
"1486","2108108",Paulo Ramos,16091,8672,53.893481,7419,-2.557119,"2108108",
"1487","2604601",Condado,23150,21254,91.809935,1896,0.864032,"2604601",
"1488","5210109",Ipameri,22840,19408,84.97373,3432,0.133307,"5210109",
"1489","3515186",Espírito Santo do Pinhal,40254,36040,89.531475,4214,-0.079949,"3515186",
"1490","2108207",Pedreiras,37868,31969,84.422203,5899,-0.718318,"2108207",
"1491","2604700",Correntes,16147,8908,55.168143,7239,-0.769367,"2604700",
"1492","4205001",Dionísio Cerqueira,14551,9344,64.215518,5207,0.299058,"4205001",
"1493","5210208",Iporá,30804,28076,91.144007,2728,-0.227933,"5210208",
"1494","2108256",Pedro do Rosário,21656,4807,22.197082,16849,2.714322,"2108256",
"1495","2604809",Cortês,11594,8298,71.571503,3296,-1.272084,"2604809",
"1496","2108306",Penalva,33384,13963,41.825425,19421,1.39481,"2108306",
"1497","3124906",Eugenópolis,10225,6659,65.124694,3566,0.658282,"3124906",
"1498","2604908",Cumaru,16370,6301,38.491142,10069,-7.137282,"2604908",
"1499","5210406",Itaberaí,30184,25113,83.199708,5071,1.141296,"5210406",
"1500","2108405",Peri Mirim,12212,3346,27.399279,8866,-0.966399,"2108405",
"1501","2605004",Cupira,22002,18653,84.778656,3349,-0.244962,"2605004",
"1502","3125101",Extrema,24574,21851,88.919183,2723,3.573653,"3125101",
"1503","2108454",Peritoró,18975,7430,39.156785,11545,1.298893,"2108454",
"1504","2605103",Custódia,32044,18968,59.193609,13076,0.960966,"2605103",
"1505","3515400",Fartura,14456,11218,77.600996,3238,-0.535804,"3515400",
"1506","2108504",Pindaré-Mirim,30881,22017,71.296266,8864,1.661322,"2108504",
"1507","2605152",Dormentes,15456,4900,31.702899,10556,1.005096,"2605152",
"1508","4205308",Faxinal dos Guedes,10329,7251,70.200407,3078,-0.591535,"4205308",
"1509","5210901",Itapaci,15938,14481,90.858326,1457,1.941312,"5210901",
"1510","2108702",Pio XII,21804,12363,56.700605,9441,-3.711559,"2108702",
"1511","2605301",Exu,30490,13051,42.804198,17439,-0.874288,"2605301",
"1512","2108801",Pirapemas,14966,9062,60.550581,5904,-0.149915,"2108801",
"1513","2605400",Feira Nova,19191,14504,75.577093,4687,0.251132,"2605400",
"1514","5211206",Itapuranga,24706,18965,76.76273,5741,-1.123843,"5211206",
"1515","2108900",Poção de Pedras,15831,7968,50.331628,7863,-4.824158,"2108900",
"1516","2109007",Porto Franco,18568,14088,75.872469,4480,1.405249,"2109007",
"1517","3125705",Felixlândia,13494,10546,78.153253,2948,0.775142,"3125705",
"1518","2605509",Ferreiros,10964,8725,79.578621,2239,0.312677,"2605509",
"1519","4205456",Forquilhinha,20609,16703,81.047115,3906,1.673961,"4205456",
"1520","2605608",Flores,21924,9285,42.350848,12639,0.73877,"2605608",
"1521","3516002",Flórida Paulista,11547,9906,85.788516,1641,0.557838,"3516002",
"1522","4205506",Fraiburgo,34812,30023,86.243249,4789,0.789264,"4205506",
"1523","2109106",Presidente Dutra,39899,28220,70.72859,11679,0.128842,"2109106",
"1524","3125903",Ferros,11305,4979,44.042459,6326,-1.23335,"3125903",
"1525","2605707",Floresta,26449,17189,64.989225,9260,0.965224,"2605707",
"1526","2109205",Presidente Juscelino,11699,4067,34.763655,7632,1.292771,"2109205",
"1527","3125952",Fervedouro,10228,4468,43.684005,5760,0.80317,"3125952",
"1528","2605806",Frei Miguelinho,14019,2863,20.422284,11156,1.108353,"2605806",
"1529","2605905",Gameleira,26167,18996,72.595254,7171,1.240781,"2605905",
"1530","5211800",Jaraguá,38462,31644,82.273413,6818,2.087109,"5211800",
"1531","4205704",Garopaba,16289,13676,83.9585,2613,3.089687,"4205704",
"1532","2109270",Presidente Sarney,15374,3702,24.079615,11672,1.641454,"2109270",
"1533","2606101",Glória do Goitá,27306,14186,51.951952,13120,-0.129077,"2606101",
"1534","2109403",Primeira Cruz,11945,4014,33.604018,7931,1.159409,"2109403",
"1535","3516705",Garça,41226,36978,89.695823,4248,-0.653446,"3516705",
"1536","2109502",Riachão,20964,9919,47.314444,11045,-0.012941,"2109502",
"1537","3126505",Francisco Badaró,10248,3030,29.566745,7218,-0.084746,"3126505",
"1538","5212204",Jussara,18710,14914,79.711384,3796,-0.971998,"5212204",
"1539","4206207",Gravatal,10500,4408,41.980952,6092,-0.400315,"4206207",
"1540","2606507",Iati,17665,7041,39.858477,10624,-0.021009,"2606507",
"1541","4206306",Guabiruba,16092,15020,93.338305,1072,3.122336,"4206306",
"1542","2109601",Rosário,37892,21908,57.816953,15984,1.704089,"2109601",
"1543","3126703",Francisco Sá,24397,14453,59.24089,9944,0.498739,"3126703",
"1544","2606606",Ibimirim,27173,14331,52.739852,12842,1.585331,"2606606",
"1545","4206405",Guaraciaba,10563,4706,44.551737,5857,-0.626409,"4206405",
"1546","3516903",General Salgado,10555,8860,83.94126,1695,-0.358872,"3516903",
"1547","2109809",Santa Helena,33682,14815,43.984918,18867,1.257885,"2109809",
"1548","2606903",Iguaraci,11863,5660,47.711371,6203,0.462429,"2606903",
"1549","3517208",Guaiçara,10316,9206,89.240016,1110,1.631707,"3517208",
"1550","5212808",Mara Rosa,10340,7640,73.887814,2700,-2.033196,"5212808",
"1551","2607000",Inajá,13881,7371,53.101362,6510,0.634316,"2607000",
"1552","4206702",Herval d'Oeste,18894,16662,88.186726,2232,-0.840525,"4206702",
"1553","3127008",Fronteira,13938,12558,90.09901,1380,6.407349,"3127008",
"1554","3517406",Guaíra,36431,34435,94.52115,1996,0.735224,"3517406",
"1555","2110039",Santa Luzia do Paruá,19568,11378,58.145953,8190,-0.352698,"2110039",
"1556","2110104",Santa Quitéria do Maranhão,28271,13167,46.574228,15104,0.061293,"2110104",
"1557","2607307",Ipubi,25645,16384,63.887697,9261,1.540749,"2607307",
"1558","4206900",Ibirama,16682,14030,84.102626,2652,0.777202,"4206900",
"1559","5213087",Minaçu,30550,26543,86.883797,4007,-1.353605,"5213087",
"1560","3517604",Guapiara,19861,7179,36.146216,12682,0.097482,"3517604",
"1561","2110203",Santa Rita,30770,15189,49.363016,15581,3.057072,"2110203",
"1562","5213103",Mineiros,44791,40413,90.225715,4378,1.988518,"5213103",
"1563","3517703",Guará,18552,17878,96.366969,674,-0.277194,"3517703",
"1564","2110237",Santana do Maranhão,10439,1768,16.936488,8671,-0.672622,"2110237",
"1565","2607505",Itaíba,26491,8946,33.76996,17545,-0.165,"2607505",
"1566","4207106",Ilhota,11451,6869,59.986027,4582,1.144773,"4207106",
"1567","2110278",Santo Amaro do Maranhão,11111,3222,28.99829,7889,2.091913,"2110278",
"1568","4207205",Imaruí,11613,3481,29.975028,8132,-2.028123,"4207205",
"1569","2110302",Santo Antônio dos Lopes,14201,5638,39.701429,8563,-0.052201,"2110302",
"1570","2607653",Itambé,34869,28486,81.694342,6383,-0.04621,"2607653",
"1571","4207304",Imbituba,36065,36065,100,0,0.145422,"4207304",
"1572","2110401",São Benedito do Rio Preto,17171,10385,60.479879,6786,0.62168,"2110401",
"1573","2607703",Itapetim,13824,7697,55.67853,6127,-0.937309,"2607703",
"1574","2110500",São Bento,37370,21662,57.966283,15708,2.323798,"2110500",
"1575","3518206",Guararapes,28578,26546,92.889635,2032,-0.131772,"3518206",
"1576","4207502",Indaial,47497,45618,96.043961,1879,2.413651,"4207502",
"1577","2110609",São Bernardo,25372,11125,43.847548,14247,1.589654,"2110609",
"1578","2607802",Itaquitinga,14967,11246,75.138638,3721,0.016237,"2607802",
"1579","5213806",Morrinhos,38834,33098,85.229438,5736,0.6974,"5213806",
"1580","2110708",São Domingos do Maranhão,32510,16371,50.356813,16139,-0.234633,"2110708",
"1581","2607950",Jaqueira,12053,7253,60.17589,4800,0.483306,"2607950",
"1582","3518503",Guareí,11358,7030,61.8947,4328,1.552337,"3518503",
"1583","3127602",Gouveia,11522,7922,68.755424,3600,-0.20536,"3127602",
"1584","2608008",Jataúba,14756,7864,53.293575,6892,0.100117,"2608008",
"1585","5214002",Mozarlândia,13080,10791,82.5,2289,2.259745,"5214002",
"1586","3518602",Guariba,32561,31899,97.966893,662,0.664913,"3518602",
"1587","2608057",Jatobá,13715,5710,41.633248,8005,0.604972,"2608057",
"1588","3127800",Grão Mogol,14428,5137,35.60438,9291,0.203637,"3127800",
"1589","2608107",João Alfredo,28423,12971,45.635577,15452,0.724186,"2608107",
"1590","2111003",São João Batista,18065,3909,21.638528,14156,-0.656189,"2111003",
"1591","2608206",Joaquim Nabuco,15941,11320,71.011856,4621,0.014347,"2608206",
"1592","2111029",São João do Carú,12177,4586,37.661164,7591,-1.457423,"2111029",
"1593","3128006",Guanhães,29139,23067,79.161948,6072,0.659807,"3128006",
"1594","2608255",Jucati,10442,2516,24.095001,7926,1.066011,"2608255",
"1595","2111052",São João do Paraíso,11225,5052,45.006682,6173,1.145203,"2111052",
"1596","3128105",Guapé,12965,6375,49.170845,6590,-0.701611,"3128105",
"1597","2608305",Jupi,13607,7028,51.649886,6579,1.418975,"2608305",
"1598","4207908",Irineópolis,10219,3251,31.813289,6968,0.697044,"4207908",
"1599","5214606",Niquelândia,38147,29028,76.095106,9119,-0.158523,"5214606",
"1600","2111078",São João do Soter,16576,6089,36.733832,10487,1.598847,"2111078",
"1601","3128204",Guaraciaba,10391,3173,30.536041,7218,0.178621,"3128204",
"1602","2608404",Jurema,14670,8614,58.718473,6056,0.93896,"2608404",
"1603","2111102",São João dos Patos,23474,19200,81.792622,4274,0.178979,"2111102",
"1604","2608453",Lagoa do Carro,14329,10292,71.826366,4037,1.278246,"2608453",
"1605","4208104",Itaiópolis,19548,9741,49.831185,9807,0.342269,"4208104",
"1606","3128303",Guaranésia,18047,16259,90.092536,1788,-0.451639,"3128303",
"1607","2608503",Lagoa do Itaenga,19970,17060,85.428142,2910,-0.143673,"2608503",
"1608","5214838",Nova Crixás,12193,7920,64.955302,4273,1.401684,"5214838",
"1609","2608602",Lagoa do Ouro,11626,5399,46.439016,6227,0.823973,"2608602",
"1610","4208302",Itapema,33656,32298,95.965058,1358,3.830781,"4208302",
"1611","2608701",Lagoa dos Gatos,15926,8308,52.166269,7618,-0.155112,"2608701",
"1612","4208401",Itapiranga,15151,7016,46.307174,8135,1.137161,"4208401",
"1613","2111409",São Luís Gonzaga do Maranhão,19253,6686,34.727056,12567,-2.369544,"2111409",
"1614","2608750",Lagoa Grande,20856,9505,45.574415,11351,1.23641,"2608750",
"1615","4208450",Itapoá,10561,9988,94.574377,573,2.575379,"4208450",
"1616","3519303",Ibaté,28002,27094,96.757374,908,0.811362,"3519303",
"1617","3128709",Guaxupé,47581,44433,93.383914,3148,0.164711,"3128709",
"1618","2111508",São Mateus do Maranhão,37893,27606,72.852506,10287,1.19935,"2111508",
"1619","2608800",Lajedo,33191,23510,70.832455,9681,0.429962,"2608800",
"1620","4208500",Ituporanga,20412,12999,63.683128,7413,0.661016,"4208500",
"1621","3519402",Ibirá,10324,9533,92.338241,791,1.276276,"3519402",
"1622","2111532",São Pedro da Água Branca,11082,9824,88.648258,1258,0.201422,"2111532",
"1623","2609006",Macaparana,23011,14508,63.048107,8503,0.325153,"2609006",
"1624","4208708",Jacinto Machado,10699,5074,47.424993,5625,-0.295568,"4208708",
"1625","3519600",Ibitinga,49635,47395,95.487056,2240,0.899256,"3519600",
"1626","2111607",São Raimundo das Mangabeiras,15915,11362,71.391769,4553,0.974955,"2111607",
"1627","2609105",Machados,11131,7600,68.277783,3531,1.797421,"2609105",
"1628","4208807",Jaguaruna,15631,11483,73.46299,4148,0.966708,"4208807",
"1629","2609154",Manari,16520,3256,19.709443,13264,3.450641,"2609154",
"1630","5215306",Orizona,14332,7647,53.356126,6685,1.32882,"5215306",
"1631","2609204",Maraial,12305,8663,70.402275,3642,-1.843723,"2609204",
"1632","2111706",São Vicente Ferrer,19647,5069,25.800377,14578,0.936471,"2111706",
"1633","3129301",Iapu,10783,7304,67.736252,3479,1.496675,"3129301",
"1634","2609303",Mirandiba,13229,6936,52.430267,6293,0.116084,"2609303",
"1635","4209003",Joaçaba,24270,22303,91.895344,1967,0.120658,"4209003",
"1636","3520004",Igaraçu do Tietê,22987,22878,99.525819,109,0.233983,"3520004",
"1637","3520103",Igarapava,26811,25112,93.663049,1699,0.481218,"3520103",
"1638","3129509",Ibiá,21962,18849,85.825517,3113,0.611838,"3129509",
"1639","2609501",Nazaré da Mata,29113,25783,88.561811,3330,-0.068998,"2609501",
"1640","2111763",Senador La Rocque,20728,8665,41.803358,12063,3.545476,"2111763",
"1641","5215702",Palmeiras de Goiás,21078,16653,79.006547,4425,2.42605,"5215702",
"1642","3520301",Iguape,28779,23026,80.009729,5753,0.689768,"3520301",
"1643","2111789",Serrano do Maranhão,10512,3578,34.037291,6934,2.049982,"2111789",
"1644","2609709",Orobó,21584,7035,32.593588,14549,-0.576209,"2609709",
"1645","3115102",Cássia,16955,14064,82.948983,2891,-0.269226,"3115102",
"1646","2111805",Sítio Novo,15518,4337,27.948189,11181,0.377556,"2111805",
"1647","3520400",Ilhabela,23632,23432,99.15369,200,1.815126,"3520400",
"1648","2609808",Orocó,13124,4369,33.290155,8755,2.7894,"2609808",
"1649","2111904",Sucupira do Norte,10199,4654,45.631925,5545,-0.248241,"2111904",
"1650","3520442",Ilha Solteira,24119,22714,94.174717,1405,0.073066,"3520442",
"1651","4209409",Laguna,49987,39672,79.364635,10315,0.711127,"4209409",
"1652","5216403",Paraúna,10595,7512,70.901369,3083,-0.318166,"5216403",
"1653","3130051",Icaraí de Minas,10308,2490,24.155995,7818,1.457582,"3130051",
"1654","2112100",Timbiras,26088,15791,60.529745,10297,-0.170233,"2112100",
"1655","2610202",Panelas,24714,12085,48.899409,12629,-0.653125,"2610202",
"1656","4209607",Lauro Muller,13671,10216,74.727525,3455,0.070209,"4209607",
"1657","2610301",Paranatama,11635,1998,17.172325,9637,1.688737,"2610301",
"1658","4209706",Lebon Régis,11701,7569,64.686779,4132,0.023219,"4209706",
"1659","2112233",Trizidela do Vale,18254,15482,84.814287,2772,1.540038,"2112233",
"1660","2610400",Parnamirim,19161,7591,39.61693,11570,-0.095069,"2610400",
"1661","3520905",Ipaussu,12913,11901,92.162937,1012,0.404744,"3520905",
"1662","2610509",Passira,27850,13078,46.958707,14772,-0.640856,"2610509",
"1663","5217104",Piracanjuba,23129,16640,71.944312,6489,-0.261597,"5217104",
"1664","2112308",Tuntum,37764,17574,46.536384,20190,0.92329,"2112308",
"1665","5217203",Piranhas,10925,8800,80.549199,2125,-1.664394,"5217203",
"1666","3130507",Ilicínea,11241,8434,75.028912,2807,0.935053,"3130507",
"1667","2112407",Turiaçu,32086,10140,31.602568,21946,0.359978,"2112407",
"1668","5217302",Pirenópolis,20298,12540,61.779486,7758,-0.6493,"5217302",
"1669","2112456",Turilândia,20034,9512,47.479285,10522,2.176501,"2112456",
"1670","2610806",Pedra,20069,11739,58.493198,8330,-0.123953,"2610806",
"1671","5217401",Pires do Rio,26695,24869,93.159768,1826,0.251897,"5217401",
"1672","2112506",Tutóia,46132,13515,29.296367,32617,2.914585,"2112506",
"1673","3521309",Ipuã,13639,13062,95.769485,577,2.004382,"3521309",
"1674","2112605",Urbano Santos,21686,14366,66.245504,7320,3.02481,"2112605",
"1675","2611002",Petrolândia,29850,21348,71.517588,8502,1.273264,"2611002",
"1676","5217708",Pontalina,16086,13077,81.294293,3009,-0.410573,"5217708",
"1677","3521408",Iracemápolis,17982,17477,97.191636,505,2.092873,"3521408",
"1678","2112704",Vargem Grande,43193,23149,53.594332,20044,3.17415,"2112704",
"1679","5218003",Porangatu,38331,32900,85.831311,5431,-0.461693,"5218003",
"1680","2112803",Viana,47304,25936,54.828344,21368,0.977552,"2112803",
"1681","2611200",Poção,11115,6801,61.187584,4314,-0.08071,"2611200",
"1682","3130903",Inhapim,24125,13859,57.446632,10266,-0.447828,"3130903",
"1683","2611309",Pombos,21723,14338,66.003775,7385,-1.027092,"2611309",
"1684","3521705",Itaberá,17441,10917,62.593888,6524,-1.149344,"3521705",
"1685","2112902",Vitória do Mearim,30826,14057,45.601116,16769,0.411258,"2112902",
"1686","2611408",Primavera,11828,7750,65.522489,4078,0.431278,"2611408",
"1687","4210506",Maravilha,21607,17459,80.802518,4148,2.226016,"4210506",
"1688","3521804",Itaí,21405,17680,82.597524,3725,0.246685,"3521804",
"1689","5218300",Posse,28384,21386,75.345265,6998,1.431438,"5218300",
"1690","2113009",Vitorino Freire,30177,14940,49.507903,15237,1.355922,"2113009",
"1691","2611507",Quipapá,24073,12168,50.546255,11905,1.199699,"2611507",
"1692","3521903",Itajobi,14133,11725,82.961862,2408,-0.097665,"3521903",
"1693","2114007",Zé Doca,44432,27514,61.923839,16918,-0.535565,"2114007",
"1694","5218508",Quirinópolis,37806,33492,88.589113,4314,0.498766,"5218508",
"1695","4210605",Massaranduba,13698,6397,46.700248,7301,1.244443,"4210605",
"1696","3131208",Ipanema,17046,13119,76.962337,3927,0.653695,"3131208",
"1697","5218607",Rialma,10407,9218,88.574998,1189,0.273388,"5218607",
"1698","2611705",Riacho das Almas,18202,8085,44.418196,10117,0.047179,"2611705",
"1699","2611804",Ribeirão,38581,30578,79.256629,8003,-1.019112,"2611804",
"1700","2611903",Rio Formoso,20803,12713,61.111378,8090,0.026811,"2611903",
"1701","2612000",Sairé,13685,7596,55.506028,6089,0.037637,"2612000",
"1702","5218904",Rubiataba,17859,15636,87.552495,2223,-0.181063,"5218904",
"1703","3131802",Itabirinha de Mantena,10307,7929,76.928301,2378,0.709979,"3131802",
"1704","3131901",Itabirito,41248,39590,95.980411,1658,1.216268,"3131901",
"1705","2612307",Saloá,15011,6873,45.786423,8138,0.004759,"2612307",
"1706","4211207",Morro da Fumaça,15304,12456,81.390486,2848,0.723383,"4211207",
"1707","2612406",Sanharó,17552,10142,57.782589,7410,1.441294,"2612406",
"1708","3522703",Itápolis,38537,34529,89.599606,4008,0.295197,"3522703",
"1709","3132107",Itacarambi,17573,13617,77.488192,3956,0.096296,"3132107",
"1710","2612455",Santa Cruz,13483,4037,29.941408,9446,2.602105,"2612455",
"1711","5219308",Santa Helena de Goiás,34770,32906,94.639057,1864,0.092788,"5219308",
"1712","3522802",Itaporanga,14173,10682,75.368659,3491,-0.18112,"3522802",
"1713","3132206",Itaguara,12205,9027,73.961491,3178,1.104137,"3132206",
"1714","2612471",Santa Cruz da Baixa Verde,11540,4556,39.480069,6984,0.827676,"2612471",
"1715","3522901",Itapuí,11516,10963,95.197985,553,1.507303,"3522901",
"1716","3132305",Itaipé,11454,4804,41.94168,6650,0.908967,"3132305",
"1717","2612554",Santa Filomena,13704,2339,17.068009,11365,1.77621,"2612554",
"1718","4211504",Nova Trento,11277,8407,74.549969,2870,1.948611,"4211504",
"1719","3132503",Itamarandiba,31687,20678,65.257045,11009,1.075916,"3132503",
"1720","2612604",Santa Maria da Boa Vista,39330,14147,35.969997,25183,0.909781,"2612604",
"1721","4211603",Nova Veneza,12484,8368,67.029798,4116,1.165955,"4211603",
"1722","3523206",Itararé,48577,44783,92.189719,3794,0.609525,"3523206",
"1723","2612703",Santa Maria do Cambucá,12307,2986,24.262615,9321,0.677306,"2612703",
"1724","3523305",Itariri,15050,14004,93.049834,1046,1.443937,"3523305",
"1725","3132701",Itambacuri,22413,14416,64.319814,7997,-0.161485,"3132701",
"1726","5219704",Santa Terezinha de Goiás,11500,8637,75.104348,2863,-0.623886,"5219704",
"1727","4211702",Orleans,20834,14484,69.520975,6350,0.563082,"4211702",
"1728","4211751",Otacílio Costa,15674,14251,90.921271,1423,1.633862,"4211751",
"1729","3523503",Itatinga,17506,15634,89.306523,1872,1.804569,"3523503",
"1730","3132909",Itamogi,10766,8088,75.125395,2678,0.057189,"3132909",
"1731","2613008",São Bento do Una,47081,24902,52.891825,22179,0.533401,"2613008",
"1732","3523602",Itirapina,11394,10075,88.423732,1319,-1.687975,"3523602",
"1733","3133006",Itamonte,13726,7784,56.709894,5942,1.701482,"3133006",
"1734","2613107",São Caitano,34544,25507,73.839162,9037,0.471104,"2613107",
"1735","3133105",Itanhandu,14327,11620,81.105605,2707,1.493274,"3133105",
"1736","2613206",São João,20963,8741,41.697276,12222,0.85952,"2613206",
"1737","3133204",Itanhomi,11837,8182,69.122244,3655,0.323978,"3133204",
"1738","2613305",São Joaquim do Monte,20794,13421,64.542657,7373,0.671726,"2613305",
"1739","3133303",Itaobim,20927,15751,75.266402,5176,-0.23265,"3133303",
"1740","2613404",São José da Coroa Grande,17027,12221,71.774241,4806,2.86626,"2613404",
"1741","3133402",Itapagipe,13935,9384,67.341227,4551,2.364609,"3133402",
"1742","3524006",Itupeva,36679,30116,82.106928,6563,4.943201,"3524006",
"1743","2613503",São José do Belmonte,32664,15258,46.711976,17406,0.450615,"2613503",
"1744","3524105",Ituverava,38441,36152,94.04542,2289,0.834733,"3524105",
"1745","3133501",Itapecerica,20466,15768,77.044855,4698,-0.525554,"3133501",
"1746","2613602",São José do Egito,30378,19550,64.355784,10828,0.435427,"2613602",
"1747","5220108",São Luís de Montes Belos,26625,23281,87.440376,3344,0.130525,"5220108",
"1748","4212106",Palmitos,16030,9386,58.552714,6644,-0.003564,"4212106",
"1749","2613800",São Vicente Ferrer,16582,10757,64.871547,5825,0.508131,"2613800",
"1750","5220207",São Miguel do Araguaia,22306,18067,80.996145,4239,-0.308064,"5220207",
"1751","4212205",Papanduva,17038,8865,52.030755,8173,0.182432,"4212205",
"1752","3133758",Itaú de Minas,14514,14186,97.740113,328,0.837416,"3133758",
"1753","2614006",Serrita,18189,5788,31.821431,12401,0.270731,"2614006",
"1754","3524600",Jacupiranga,16061,8460,52.67418,7601,-0.842548,"3524600",
"1755","2614105",Sertânia,33954,17000,50.067739,16954,1.0057,"2614105",
"1756","5220405",São Simão,13616,13254,97.341363,362,0.067329,"5220405",
"1757","3134004",Itinga,14512,6328,43.605292,8184,0.623634,"3134004",
"1758","2614204",Sirinhaém,36290,19214,52.945715,17076,1.346726,"2614204",
"1759","3524808",Jales,47379,44399,93.710294,2980,0.364984,"3524808",
"1760","2614303",Moreilândia,10417,6262,60.113276,4155,-0.923515,"2614303",
"1761","5220603",Silvânia,18211,11768,64.620284,6443,-1.56638,"5220603",
"1762","4212502",Penha,20767,18931,91.15905,1836,2.327301,"4212502",
"1763","3134400",Iturama,31089,29186,93.878864,1903,1.091524,"3134400",
"1764","2614600",Tabira,25780,18340,71.140419,7440,0.988287,"2614600",
"1765","3525201",Jarinu,20524,16079,78.342428,4445,2.69236,"3525201",
"1766","2614709",Tacaimbó,12085,6567,54.340091,5518,-0.959762,"2614709",
"1767","4212809",Piçarras,13740,12477,90.80786,1263,3.34826,"4212809",
"1768","3134608",Jaboticatubas,15363,9218,60.001302,6145,1.831609,"3134608",
"1769","2614808",Tacaratu,20486,8961,43.742068,11525,2.617927,"2614808",
"1770","4212908",Pinhalzinho,14659,11903,81.199263,2756,2.471661,"4212908",
"1771","3134707",Jacinto,12364,8971,72.557425,3393,0.324218,"3134707",
"1772","2614857",Tamandaré,18090,12504,69.121061,5586,0.655736,"2614857",
"1773","3525508",Joanópolis,10613,10613,100,0,0.277654,"3525508",
"1774","2615003",Taquaritinga do Norte,21317,15309,71.815922,6008,1.091586,"2615003",
"1775","3134905",Jacutinga,20245,16591,81.951099,3654,0.907787,"3134905",
"1776","3525706",José Bonifácio,30558,27665,90.532757,2893,0.893132,"3525706",
"1777","4213203",Pomerode,25100,21849,87.047809,3251,1.817305,"4213203",
"1778","3135050",Jaíba,30201,15471,51.226781,14730,1.460051,"3135050",
"1779","2615409",Toritama,29835,28718,96.256075,1117,4.584441,"2615409",
"1780","2615508",Tracunhaém,12713,10683,84.032093,2030,0.363697,"2615508",
"1781","4213401",Ponte Serrada,10886,7701,70.742238,3185,0.433933,"4213401",
"1782","3526001",Junqueirópolis,17507,15129,86.416862,2378,0.416485,"3526001",
"1783","2615607",Trindade,24477,19629,80.193651,4848,1.582075,"2615607",
"1784","5221601",Uruaçu,33160,30122,90.838359,3038,-0.158392,"5221601",
"1785","4213500",Porto Belo,13200,12377,93.765152,823,3.039555,"4213500",
"1786","3526100",Juquiá,19199,12299,64.060628,6900,-0.943335,"3526100",
"1787","2615706",Triunfo,15177,7183,47.328194,7994,0.039596,"2615706",
"1788","4213609",Porto União,32142,27328,85.022712,4814,0.126867,"4213609",
"1789","5221700",Uruana,13632,11240,82.453052,2392,-0.316626,"5221700",
"1790","2615805",Tupanatinga,18505,6904,37.308835,11601,-1.656977,"2615805",
"1791","4213708",Pouso Redondo,13699,7908,57.726841,5791,1.665736,"4213708",
"1792","3526407",Laranjal Paulista,24328,22253,91.470733,2075,1.352149,"3526407",
"1793","2616001",Venturosa,15555,9544,61.356477,6011,2.085903,"2616001",
"1794","5222005",Vianópolis,12138,9059,74.633383,3079,1.027216,"5222005",
"1795","3135506",Jequeri,12927,6899,53.368918,6028,-0.782739,"3135506",
"1796","4214003",Presidente Getúlio,13543,9073,66.994019,4470,1.345995,"4214003",
"1797","2616209",Vertentes,16961,8218,48.452332,8743,1.812475,"2616209",
"1798","3135803",Jequitinhonha,23314,16748,71.836665,6566,0.255036,"3135803",
"1799","2616308",Vicência,27324,11132,40.740741,16192,-0.758596,"2616308",
"1800","4214201",Quilombo,10788,5525,51.214312,5263,0.06905,"4214201",
"1801","5213004",Maurilândia,10404,9944,95.578624,460,2.142867,"5213004",
"1802","3136009",Joaíma,14847,10330,69.576345,4517,0.284164,"3136009",
"1803","2616506",Xexéu,14212,9057,63.727836,5155,0.633965,"2616506",
"1804","2700102",Água Branca,19251,5344,27.759597,13907,0.446434,"2700102",
"1805","2700201",Anadia,17246,9105,52.794851,8141,-0.489757,"2700201",
"1806","3136306",João Pinheiro,42729,33843,79.203819,8886,0.463502,"3136306",
"1807","2700409",Atalaia,49651,24290,48.921472,25361,2.934128,"2700409",
"1808","3527405",Lucélia,18021,16673,92.519838,1348,-0.231692,"3527405",
"1809","3136504",Jordânia,10683,7790,72.919592,2893,1.144508,"3136504",
"1810","2700508",Barra de Santo Antônio,13640,12271,89.963343,1369,2.659035,"2700508",
"1811","4215000",Rio Negrinho,41788,37887,90.664784,3901,1.478878,"4215000",
"1812","2700706",Batalha,16113,11227,69.676659,4886,1.222654,"2700706",
"1813","4215109",Rodeio,10667,9177,86.031687,1490,0.390388,"4215109",
"1814","2701001",Boca da Mata,25054,16425,65.558394,8629,0.480663,"2701001",
"1815","3528007",Macatuba,16134,15665,97.093095,469,0.342894,"3528007",
"1816","2701100",Branquinha,11396,6685,58.660934,4711,0.089322,"2701100",
"1817","2701308",Cajueiro,20003,15986,79.918012,4017,0.756561,"2701308",
"1818","4215455",Sangão,10243,4844,47.290833,5399,3.359183,"4215455",
"1819","3137007",Ladainha,16455,4195,25.493771,12260,0.552897,"3137007",
"1820","2701407",Campo Alegre,45085,18420,40.856161,26665,1.356183,"2701407",
"1821","4215505",Santa Cecília,15217,13024,85.588487,2193,0.395794,"4215505",
"1822","3137205",Lagoa da Prata,43810,42829,97.760785,981,1.765764,"3137205",
"1823","2701605",Canapi,17598,5062,28.764632,12536,0.216167,"2701605",
"1824","2110906",São Francisco do Maranhão,14163,3715,26.230318,10448,1.395039,"2110906",
"1825","2701704",Capela,16753,12496,74.589626,4257,-1.553124,"2701704",
"1826","3528809",Maracaí,13129,11597,88.331175,1532,0.136758,"3528809",
"1827","3137403",Lagoa Dourada,11759,6434,54.715537,5325,0.336135,"3137403",
"1828","3137502",Lagoa Formosa,16444,11907,72.409389,4537,0.131874,"3137502",
"1829","2200202",Água Branca,15854,14252,89.895295,1602,1.266546,"2200202",
"1830","2702009",Coité do Nóia,10853,3598,33.152124,7255,-1.416748,"2702009",
"1831","2702108",Colônia Leopoldina,19320,14419,74.632505,4901,1.429261,"2702108",
"1832","3137700",Lajinha,17514,10682,60.991207,6832,-1.542955,"3137700",
"1833","3529203",Martinópolis,22696,19749,87.015333,2947,0.222266,"3529203",
"1834","3137809",Lambari,18442,13516,73.289231,4926,0.150404,"3137809",
"1835","2200301",Alto Longá,13607,6171,45.351657,7436,1.81161,"2200301",
"1836","2702306",Coruripe,49942,41814,83.725121,8128,0.317501,"2702306",
"1837","2200400",Altos,38263,26833,70.1278,11430,-0.316663,"2200400",
"1838","2702355",Craíbas,21765,6956,31.959568,14809,0.657569,"2702355",
"1839","2702405",Delmiro Gouveia,45989,33447,72.728261,12542,0.966331,"2702405",
"1840","4216008",São Carlos,10257,6703,65.350492,3554,1.309758,"4216008",
"1841","2200509",Amarante,17244,8932,51.797727,8312,0.301852,"2200509",
"1842","2702504",Dois Riachos,10840,4804,44.317343,6036,-0.294342,"2702504",
"1843","2702553",Estrela de Alagoas,16679,3753,22.501349,12926,0.292902,"2702553",
"1844","2702603",Feira Grande,21085,3276,15.537112,17809,-0.124718,"2702603",
"1845","4216206",São Francisco do Sul,37343,34856,93.340117,2487,2.093721,"4216206",
"1846","3529708",Miguelópolis,19893,17884,89.90097,2009,0.643913,"3529708",
"1847","3529807",Mineiros do Tietê,11702,11244,96.086139,458,0.361647,"3529807",
"1848","3138401",Leopoldina,49490,43929,88.763387,5561,-0.173998,"3138401",
"1849","2702801",Flexeiras,10477,7592,72.463491,2885,-1.895698,"2702801",
"1850","4216305",São João Batista,21972,16191,73.689241,5781,5.745093,"4216305",
"1851","3529906",Miracatu,22645,11047,48.783396,11598,0.166386,"3529906",
"1852","2702900",Girau do Ponciano,34618,10388,30.007511,24230,2.275185,"2702900",
"1853","3138609",Lima Duarte,15786,11495,72.817687,4291,0.070787,"3138609",
"1854","2703007",Ibateguara,15321,8771,57.248221,6550,0.203043,"2703007",
"1855","3530102",Mirandópolis,23857,20818,87.2616,3039,-1.186537,"3530102",
"1856","2201101",Avelino Lopes,11499,6334,55.083051,5165,2.573942,"2201101",
"1857","2703106",Igaci,25101,5943,23.676348,19158,-0.271908,"2703106",
"1858","3530201",Mirante do Paranapanema,16339,9583,58.65108,6756,0.110654,"3530201",
"1859","4216503",São Joaquim,23928,17050,71.255433,6878,0.669533,"4216503",
"1860","2201150",Baixa Grande do Ribeiro,10108,5524,54.649782,4584,3.812292,"2201150",
"1861","2703205",Igreja Nova,22891,4818,21.047573,18073,0.9325,"2703205",
"1862","2703304",Inhapi,17193,6282,36.538126,10911,-0.468851,"2703304",
"1863","4216701",São José do Cedro,13611,7671,56.358827,5940,-0.070124,"4216701",
"1864","2201200",Barras,43246,20933,48.404477,22313,0.803133,"2201200",
"1865","4216800",São José do Cerrito,10119,2386,23.579405,7733,-0.380953,"4216800",
"1866","4216909",São Lourenço do Oeste,21671,16290,75.169581,5381,1.410575,"4216909",
"1867","3138807",Luz,16963,14966,88.227318,1997,0.109964,"3138807",
"1868","4217006",São Ludgero,10218,8296,81.190057,1922,2.515422,"4217006",
"1869","2201507",Batalha,25696,8463,32.935087,17233,0.904117,"2201507",
"1870","2703809",Joaquim Gomes,21029,14037,66.750678,6992,-0.307985,"2703809",
"1871","4217204",São Miguel do Oeste,33658,29682,88.187058,3976,0.579397,"4217204",
"1872","3139201",Malacacheta,17821,10817,60.698053,7004,-1.095859,"3139201",
"1873","2704005",Junqueiro,24373,7517,30.841505,16856,0.321183,"2704005",
"1874","2704104",Lagoa da Canoa,17797,8874,49.862336,8923,-1.644924,"2704104",
"1875","3139300",Manga,20739,14283,68.870244,6456,-0.813262,"3139300",
"1876","2704203",Limoeiro de Anadia,25428,2145,8.435583,23283,0.672226,"2704203",
"1877","3531308",Monte Alto,43919,42305,96.325053,1614,0.099932,"3531308",
"1878","4217501",Seara,17111,11654,68.108234,5457,0.534729,"4217501",
"1879","3531407",Monte Aprazível,19662,17662,89.828095,2000,0.941993,"3531407",
"1880","3139508",Manhumirim,20065,16542,82.442063,3523,0.028511,"3139508",
"1881","2704401",Major Isidoro,18596,9168,49.300925,9428,0.757629,"2704401",
"1882","3531506",Monte Azul Paulista,19152,17691,92.371554,1461,-0.295585,"3531506",
"1883","2201903",Bom Jesus,19440,14328,73.703704,5112,2.89108,"2201903",
"1884","3139607",Mantena,26451,20380,77.048127,6071,-0.22533,"3139607",
"1885","2704500",Maragogi,24758,16223,65.526295,8535,1.81298,"2704500",
"1886","4217600",Siderópolis,12448,9597,77.096722,2851,0.427242,"4217600",
"1887","2704609",Maravilha,10156,4660,45.884206,5496,-4.173026,"2704609",
"1888","4217709",Sombrio,24337,16862,69.28545,7475,0.834277,"4217709",
"1889","3139805",Mar de Espanha,11088,10027,90.431097,1061,0.689905,"3139805",
"1890","2704708",Marechal Deodoro,44995,37452,83.235915,7543,3.292493,"2704708",
"1891","3139904",Maria da Fé,14182,7827,55.189677,6355,-0.42093,"3139904",
"1892","2704807",Maribondo,13802,9863,71.460658,3939,-1.317768,"2704807",
"1893","4217808",Taió,16743,8837,52.780266,7906,0.421696,"4217808",
"1894","3531902",Morro Agudo,25303,23633,93.399992,1670,-0.070375,"3531902",
"1895","2705002",Mata Grande,24503,5204,21.238216,19299,-0.30467,"2705002",
"1896","2202000",Buriti dos Lopes,19126,9633,50.365994,9493,0.400724,"2202000",
"1897","2705101",Matriz de Camaragibe,24600,20334,82.658537,4266,0.343224,"2705101",
"1898","4218004",Tijucas,27418,23043,84.043329,4375,2.227911,"4218004",
"1899","2705200",Messias,14987,13552,90.425035,1435,3.238626,"2705200",
"1900","4218202",Timbó,33172,30423,91.71289,2749,1.760184,"4218202",
"1901","3140506",Martinho Campos,12146,9991,82.257533,2155,0.393067,"3140506",
"1902","2705507",Murici,25456,20788,81.662476,4668,0.448474,"2705507",
"1903","4218301",Três Barras,17883,15185,84.913046,2698,0.621488,"4218301",
"1904","2705606",Novo Lino,11610,6971,60.043066,4639,1.619658,"2705606",
"1905","2705705",Olho d'Água das Flores,19814,13477,68.017563,6337,0.289558,"2705705",
"1906","3532603",Nhandeara,10211,8233,80.628734,1978,0.023807,"3532603",
"1907","2706000",Olivença,10478,2504,23.89769,7974,0.149501,"2706000",
"1908","2202208",Campo Maior,44504,32263,72.494607,12241,0.45034,"2202208",
"1909","2706109",Ouro Branco,11017,6605,59.9528,4412,1.282207,"2706109",
"1910","3140902",Matipó,16348,12481,76.34573,3867,0.049909,"3140902",
"1911","4218806",Turvo,10998,7213,65.584652,3785,0.14502,"4218806",
"1912","2202307",Canto do Buriti,20583,10422,50.634018,10161,1.637435,"2202307",
"1913","3141009",Mato Verde,12646,9190,72.6712,3456,-0.594495,"3141009",
"1914","2202406",Capitão de Campos,10822,6222,57.493994,4600,1.083001,"2202406",
"1915","2706406",Pão de Açúcar,23793,10427,43.823814,13366,-0.330616,"2706406",
"1916","4218905",Urubici,10409,7307,70.198866,3102,0.21735,"4218905",
"1917","3533007",Nova Granada,17635,16180,91.749362,1455,0.50838,"3533007",
"1918","2706422",Pariconha,10199,2707,26.541818,7492,0.159289,"2706422",
"1919","2202505",Caracol,10287,3807,37.007874,6480,3.583453,"2202505",
"1920","4219002",Urussanga,18569,10711,57.682158,7858,-0.120967,"4219002",
"1921","3141405",Medina,20530,14292,69.615197,6238,-0.750065,"3141405",
"1922","2706505",Passo de Camaragibe,13797,6889,49.931144,6908,0.043564,"2706505",
"1923","3141603",Mercês,10357,6783,65.491938,3574,0.415088,"3141603",
"1924","2202604",Castelo do Piauí,18428,11256,61.080964,7172,0.069185,"2202604",
"1925","2706802",Piaçabuçu,17329,10299,59.432166,7030,0.465246,"2706802",
"1926","3533502",Novo Horizonte,34161,31672,92.713914,2489,0.744746,"3533502",
"1927","3141801",Minas Novas,30504,12217,40.050485,18287,-0.066326,"3141801",
"1928","2202703",Cocal,26062,11062,42.444939,15000,1.09443,"2202703",
"1929","2706901",Pilar,31462,29914,95.079779,1548,0.119075,"2706901",
"1930","4219309",Videira,44357,38942,87.792231,5415,0.924747,"4219309",
"1931","3142007",Mirabela,12716,9813,77.170494,2903,0.185615,"3142007",
"1932","2707107",Piranhas,23765,13458,56.629497,10307,2.489508,"2707107",
"1933","3142106",Miradouro,10133,5481,54.090595,4652,0.522517,"3142106",
"1934","2707206",Poço das Trincheiras,12118,1915,15.802938,10203,-1.237849,"2707206",
"1935","4219507",Xanxerê,40054,36228,90.447895,3826,0.973028,"4219507",
"1936","3533908",Olímpia,47851,45092,94.234185,2759,0.561112,"3533908",
"1937","3142205",Miraí,12869,10082,78.343306,2787,0.440598,"3142205",
"1938","2707305",Porto Calvo,24997,18296,73.192783,6701,0.612522,"2707305",
"1939","2707404",Porto de Pedras,10110,5412,53.531157,4698,-0.179571,"2707404",
"1940","4219705",Xaxim,24251,17989,74.178384,6262,0.849307,"4219705",
"1941","2707503",Porto Real do Colégio,17673,5812,32.886324,11861,-0.539453,"2707503",
"1942","2707602",Quebrangulo,11254,6539,58.103785,4715,-0.796565,"2707602",
"1943","3534302",Orlândia,36027,35405,98.273517,622,0.009123,"3534302",
"1944","2202901",Corrente,24352,13980,57.408016,10372,0.678601,"2202901",
"1945","3142700",Montalvânia,15914,9858,61.945457,6056,-0.10459,"3142700",
"1946","4300109",Agudo,16577,6522,39.343669,10055,-0.734574,"4300109",
"1947","3534609",Osvaldo Cruz,28761,26704,92.847954,2057,-0.432979,"3534609",
"1948","3142809",Monte Alegre de Minas,18257,13165,72.109328,5092,0.19796,"3142809",
"1949","2203206",Curimatá,10300,5931,57.582524,4369,1.134374,"2203206",
"1950","2708006",Santana do Ipanema,42202,25391,60.165395,16811,0.245096,"2708006",
"1951","3142908",Monte Azul,22407,11823,52.764761,10584,-0.87693,"3142908",
"1952","2708105",Santana do Mundaú,11586,6192,53.443811,5394,0.064282,"2708105",
"1953","3143005",Monte Belo,12481,8531,68.351895,3950,-0.734514,"3143005",
"1954","3143104",Monte Carmelo,44128,38452,87.137418,5676,0.074356,"3143104",
"1955","2708303",São José da Laje,22205,14197,63.93605,8008,0.751665,"2708303",
"1956","3534906",Pacaembu,10959,9571,87.334611,1388,-1.882156,"3534906",
"1957","2708402",São José da Tapera,30059,10951,36.431684,19108,1.246622,"2708402",
"1958","3535002",Palestina,10292,8649,84.036145,1643,1.774016,"3535002",
"1959","3143203",Monte Santo de Minas,19975,15745,78.823529,4230,-0.854692,"3143203",
"1960","2708501",São Luís do Quitunde,31465,19464,61.859209,12001,0.90448,"2708501",
"1961","3535101",Palmares Paulista,10473,10201,97.402845,272,3.136375,"3535101",
"1962","3143401",Monte Sião,19064,14097,73.945657,4967,0.668725,"3143401",
"1963","3535309",Palmital,21222,19197,90.458015,2025,0.355722,"3535309",
"1964","2203453",Dom Inocêncio,10266,1985,19.335671,8281,2.046013,"2203453",
"1965","2708808",São Sebastião,30890,11365,36.791842,19525,0.844545,"2708808",
"1966","3535408",Panorama,13896,13349,96.063615,547,0.25654,"3535408",
"1967","2203503",Elesbão Veloso,14151,9632,68.065861,4519,-0.83079,"2203503",
"1968","3535507",Paraguaçu Paulista,40831,37868,92.743259,2963,0.431758,"3535507",
"1969","2708956",Senador Rui Palmeira,12598,4056,32.195587,8542,0.722353,"2708956",
"1970","3535606",Paraibuna,16385,5023,30.656088,11362,-0.532525,"3535606",
"1971","2203701",Esperantina,36109,21841,60.486305,14268,0.82367,"2203701",
"1972","2709103",Taquarana,18093,4103,22.677279,13990,0.855201,"2709103",
"1973","4300802",Antônio Prado,13582,9497,69.923428,4085,0.718623,"4300802",
"1974","3535804",Paranapanema,16618,13250,79.73282,3368,0.99061,"3535804",
"1975","2709152",Teotônio Vilela,40153,32882,81.891764,7271,1.221697,"2709152",
"1976","3144003",Mutum,26194,13156,50.225242,13038,-0.269222,"3144003",
"1977","2709202",Traipu,24557,7838,31.91758,16719,0.667872,"2709202",
"1978","3536000",Parapuã,10950,8955,81.780822,1995,-0.199315,"3536000",
"1979","3144102",Muzambinho,19810,14574,73.568905,5236,-0.549486,"3144102",
"1980","2709400",Viçosa,25910,18799,72.554998,7111,-0.193129,"2709400",
"1981","4301008",Arroio do Meio,17937,13843,77.17567,4094,0.810968,"4301008",
"1982","3536208",Pariquera-Açu,18000,12593,69.961111,5407,0.281719,"3536208",
"1983","3144300",Nanuque,40093,37056,92.425112,3037,-0.532222,"3144300",
"1984","2807402",Tobias Barreto,46856,30821,65.778129,16035,1.176682,"2807402",
"1985","2805505",Poço Verde,21031,11484,54.605107,9547,0.740099,"2805505",
"1986","3536307",Patrocínio Paulista,12151,9990,82.215456,2161,0.89535,"3536307",
"1987","2800407",Arauá,11594,4433,38.235294,7161,2.487439,"2800407",
"1988","4301206",Arroio do Tigre,12621,5854,46.383012,6767,0.467023,"4301206",
"1989","2204303",Fronteiras,11049,6726,60.874287,4323,1.417895,"2204303",
"1990","2801702",Cristinápolis,15813,7850,49.642699,7963,1.479598,"2801702",
"1991","4301305",Arroio Grande,18296,15718,85.909488,2578,-0.651081,"4301305",
"1992","4301404",Arvorezinha,10134,5824,57.469903,4310,-0.179149,"4301404",
"1993","2204402",Gilbués,10311,4999,48.482203,5312,0.114129,"2204402",
"1994","3144607",Nepomuceno,24249,18562,76.547486,5687,-0.333087,"3144607",
"1995","2802809",Indiaroba,16609,5247,31.591306,11362,3.390066,"2802809",
"1996","3144656",Ninheira,10389,2678,25.777264,7711,1.507387,"3144656",
"1997","2803005",Itabaianinha,37252,17970,48.239021,19282,0.709211,"2803005",
"1998","3536703",Pederneiras,39733,36981,93.073767,2752,1.174723,"3536703",
"1999","3144706",Nova Era,17656,15322,86.780698,2334,-0.079043,"3144706",
"2000","2806305",Santa Luzia do Itanhy,12906,2827,21.904541,10079,-1.103068,"2806305",
"2001","4301636",Balneário Pinhal,10438,9984,95.650508,454,4.931613,"4301636",
"2002","2807501",Tomar do Geru,12834,4535,35.335827,8299,-0.006677,"2807501",
"2003","3537008",Pedregulho,15042,10776,71.63941,4266,0.04567,"3537008",
"2004","2204709",Inhuma,14949,6925,46.324169,8024,0.510043,"2204709",
"2005","2807600",Umbaúba,20520,12085,58.893762,8435,0.943867,"2807600",
"2006","3145000",Nova Ponte,11486,9816,85.460561,1670,2.761434,"3145000",
"2007","2800506",Areia Branca,15492,6997,45.165247,8495,0.631648,"2800506",
"2008","2800670",Boquim,24397,14934,61.212444,9463,0.122983,"2800670",
"2009","3145109",Nova Resende,14088,7992,56.729131,6096,0.2055,"3145109",
"2010","2205003",Itainópolis,11075,2606,23.530474,8469,0.928759,"2205003",
"2011","2803203",Itaporanga d'Ajuda,27990,9252,33.054662,18738,1.350104,"2803203",
"2012","2205102",Itaueira,10511,5272,50.156978,5239,0.224905,"2205102",
"2013","3537404",Pereira Barreto,24139,22628,93.74042,1511,-0.515331,"3537404",
"2014","3145307",Novo Cruzeiro,30222,9259,30.636622,20963,-0.108718,"3145307",
"2015","2805802",Riachão do Dantas,18980,4393,23.145416,14587,-0.165986,"2805802",
"2016","4301909",Barra do Ribeiro,11386,8834,77.58651,2552,-0.562999,"4301909",
"2017","2205201",Jaicós,16782,7789,46.412823,8993,0.811413,"2205201",
"2018","3145356",Novo Oriente de Minas,10278,4159,40.465071,6119,0.429835,"3145356",
"2019","2806206",Salgado,18540,5563,30.005394,12977,-0.256253,"2806206",
"2020","2806800",São Domingos,10077,4795,47.583606,5282,1.215204,"2806800",
"2021","2801009",Campo do Brito,16068,7536,46.900672,8532,0.820208,"2801009",
"2022","4302006",Barros Cassal,11388,3528,30.979979,7860,0.051539,"4302006",
"2023","3537800",Piedade,47765,21401,44.804773,26364,-0.688284,"3537800",
"2024","2801405",Carira,18851,10185,54.028964,8666,0.847202,"2801405",
"2025","3537909",Pilar do Sul,26231,20347,77.568526,5884,1.309313,"3537909",
"2026","2802304",Frei Paulo,12572,7047,56.053134,5525,0.699838,"2802304",
"2027","3145604",Oliveira,37645,33528,89.063621,4117,0.150802,"3145604",
"2028","2205409",Joaquim Pires,13774,4095,29.729926,9679,0.745685,"2205409",
"2029","3538105",Pindorama,14212,13375,94.110611,837,1.160795,"3538105",
"2030","3538204",Pinhalzinho,11776,5836,49.558424,5940,0.996963,"3538204",
"2031","2205508",José de Freitas,35087,19976,56.932767,15111,0.942059,"2205508",
"2032","2803906",Malhador,11705,5321,45.459205,6384,0.276419,"2803906",
"2033","2804102",Moita Bonita,10857,4235,39.007092,6622,0.130948,"2804102",
"2034","4302303",Bom Jesus,11802,8814,74.682257,2988,-0.254014,"4302303",
"2035","3538501",Piquete,14402,13536,93.986946,866,-0.767445,"3538501",
"2036","4302352",Bom Princípio,10889,8193,75.241069,2696,1.977777,"4302352",
"2037","3145901",Ouro Branco,33385,29500,88.363037,3885,1.355149,"3145901",
"2038","3146008",Ouro Fino,30903,21914,70.912209,8989,0.706981,"3146008",
"2039","4302402",Bom Retiro do Sul,11101,8678,78.173138,2423,0.409419,"4302402",
"2040","3538808",Piraju,28113,25145,89.442607,2968,0.110246,"3538808",
"2041","2806008",Ribeirópolis,15573,10595,68.034419,4978,0.123532,"2806008",
"2042","3538907",Pirajuí,18332,16415,89.542876,1917,-1.303189,"3538907",
"2043","3539004",Pirangi,10251,9188,89.63028,1063,0.300413,"3539004",
"2044","2807105",Simão Dias,36954,18683,50.55745,18271,0.054627,"2807105",
"2045","3146305",Padre Paraíso,18044,11171,61.909776,6873,0.458791,"3146305",
"2046","2804201",Monte Alegre de Sergipe,13189,7505,56.90348,5684,1.867209,"2804201",
"2047","3539202",Pirapozinho,23605,22443,95.077314,1162,0.942989,"3539202",
"2048","2804508",Nossa Senhora da Glória,29255,18647,63.739532,10608,1.20076,"2804508",
"2049","4302709",Butiá,19675,18443,93.738247,1232,-0.461151,"4302709",
"2050","2801207",Canindé de São Francisco,21625,11916,55.10289,9709,2.857776,"2801207",
"2051","4302808",Caçapava do Sul,32451,18921,58.30637,13530,-0.929431,"4302808",
"2052","3539400",Piratininga,11158,9558,85.660513,1600,0.757329,"3539400",
"2053","2205706",Luís Correia,26058,11120,42.674035,14938,1.030769,"2205706",
"2054","2805406",Poço Redondo,28904,7247,25.072654,21657,1.511853,"2805406",
"2055","4302907",Cacequi,13568,11842,87.278892,1726,-1.711716,"4302907",
"2056","3539509",Pitangueiras,33240,31786,95.625752,1454,0.92925,"3539509",
"2057","2205805",Luzilândia,24302,13274,54.621019,11028,0.15378,"2205805",
"2058","3146909",Papagaios,14253,12025,84.368203,2228,1.925172,"3146909",
"2059","3540002",Pompéia,19035,17932,94.205411,1103,0.665814,"3540002",
"2060","3147204",Paraguaçu,19529,15749,80.64417,3780,0.436936,"3147204",
"2061","2206100",Matias Olímpio,10430,4191,40.182167,6239,1.001853,"2206100",
"2062","2806602",Santo Amaro das Brotas,11617,8676,74.683653,2941,1.222172,"2806602",
"2064","3147303",Paraisópolis,17938,15084,84.089642,2854,0.355413,"3147303",
"2065","2206209",Miguel Alves,32112,10398,32.380419,21714,1.049446,"2206209",
"2066","3147402",Paraopeba,22152,19252,86.908631,2900,1.196047,"3147402",
"2067","2801306",Capela,27767,16473,59.325818,11294,0.659659,"2801306",
"2068","2801504",Carmópolis,11842,9696,81.878061,2146,3.429826,"2801504",
"2069","3147600",Passa Quatro,15225,11632,76.400657,3593,0.35208,"3147600",
"2070","2206407",Monsenhor Gil,10290,5203,50.563654,5087,-0.02635,"2206407",
"2071","2206605",Monte Alegre do Piauí,10320,2754,26.686047,7566,0.125209,"2206605",
"2072","3540705",Porto Ferreira,48676,47135,96.834169,1541,0.369016,"3540705",
"2073","2803302",Japaratuba,15430,7366,47.738172,8064,0.836485,"2803302",
"2074","3540754",Potim,15487,13911,89.823723,1576,1.868144,"3540754",
"2075","2803401",Japoatã,13377,3961,29.610526,9416,0.387179,"2803401",
"2076","4304200",Candelária,29276,14219,48.568794,15057,-0.149879,"4304200",
"2077","3540804",Potirendaba,14300,12814,89.608392,1486,0.660465,"3540804",
"2078","3540903",Pradópolis,15122,13921,92.057929,1201,2.282714,"3540903",
"2079","2804607",Nossa Senhora das Dores,23739,15234,64.17288,8505,0.965376,"2804607",
"2080","4304408",Canela,38030,34680,91.191165,3350,1.774205,"4304408",
"2081","2804904",Pacatuba,12274,2609,21.256314,9665,0.889801,"2804904",
"2082","3541208",Presidente Bernardes,13633,10544,77.341744,3089,-1.034127,"3541208",
"2083","4304630",Capão da Canoa,37294,37090,99.452995,204,2.915571,"4304630",
"2084","3148608",Peçanha,17050,8374,49.11437,8676,-0.110943,"3148608",
"2085","2207009",Oeiras,34981,20660,59.060633,14321,0.445204,"2207009",
"2086","4304663",Capão do Leão,23614,21682,91.818413,1932,-0.062759,"4304663",
"2087","3541307",Presidente Epitácio,39120,36563,93.463701,2557,-0.064833,"3541307",
"2088","3148707",Pedra Azul,24751,21959,88.719648,2792,0.677718,"3148707",
"2089","3541505",Presidente Venceslau,35674,34045,95.433649,1629,-0.652582,"3541505",
"2090","2800209",Aquidabã,19145,10446,54.562549,8699,0.612425,"2800209",
"2091","3541604",Promissão,33680,29115,86.445962,4565,1.142703,"3541604",
"2092","3541703",Quatá,11837,11094,93.723072,743,0.221602,"3541703",
"2093","3149101",Pedralva,11110,5182,46.642664,5928,-1.105427,"3149101",
"2094","2207504",Palmeirais,13673,5070,37.080377,8603,1.696585,"2207504",
"2095","2802403",Gararu,11594,2789,24.055546,8805,0.287917,"2802403",
"2096","4304804",Carlos Barbosa,23883,18731,78.428171,5152,2.192484,"4304804",
"2097","3149150",Pedras de Maria da Cruz,10798,6130,56.769772,4668,2.847993,"3149150",
"2098","3541901",Queluz,10211,9246,90.549408,965,1.640066,"3541901",
"2099","2207603",Parnaguá,10138,5090,50.207141,5048,1.170357,"2207603",
"2100","2805604",Porto da Folha,26486,9486,35.815148,17000,0.451402,"2805604",
"2101","3542206",Rancharia,28154,24978,88.719187,3176,-0.309709,"3542206",
"2102","2805703",Propriá,27549,23489,85.262623,4060,0.085334,"2805703",
"2103","2207801",Paulistana,16890,9781,57.910006,7109,0.309124,"2207801",
"2104","3542404",Regente Feijó,17009,15643,91.968958,1366,0.009242,"3542404",
"2105","3149804",Perdizes,13661,8715,63.794744,4946,1.435289,"3149804",
"2106","2207900",Pedro II,36491,21586,59.154312,14905,0.114049,"2207900",
"2107","3149903",Perdões,19319,17025,88.125679,2294,0.438706,"3149903",
"2108","2804409",Neópolis,18857,10448,55.40648,8409,0.201618,"2804409",
"2109","4305207",Cerro Largo,12324,9391,76.200909,2933,-0.389151,"4305207",
"2110","3542909",Ribeirão Bonito,11325,10480,92.538631,845,0.100052,"3542909",
"2111","2208106",Pimenteiras,11691,4605,39.389274,7086,0.479514,"2208106",
"2112","3543006",Ribeirão Branco,18818,9727,51.689871,9091,-1.708782,"3543006",
"2113","2208205",Pio IX,16923,5014,29.628316,11909,0.357929,"2208205",
"2114","4305355",Charqueadas,29998,29374,97.919861,624,0.017633,"4305355",
"2115","2208304",Piracuruca,25562,17570,68.734841,7992,0.44137,"2208304",
"2116","2900207",Abaré,17306,8305,47.989137,9001,3.450484,"2900207",
"2117","2900306",Acajutiba,14585,12292,84.278368,2293,0.260292,"2900306",
"2118","2208502",Porto,11429,7329,64.126345,4100,1.118356,"2208502",
"2119","2900355",Adustina,14779,4973,33.649097,9806,0.469784,"2900355",
"2120","2900405",Água Fria,14569,5194,35.65104,9375,-0.145255,"2900405",
"2121","2900504",Érico Cardoso,10588,1536,14.506989,9052,-1.958154,"2900504",
"2122","4305454",Cidreira,10849,10413,95.981196,436,2.899029,"4305454",
"2123","2208809",Regeneração,17595,13521,76.845695,4074,0.101085,"2208809",
"2124","2900801",Alcobaça,19600,10366,52.887755,9234,-0.913227,"2900801",
"2125","3543709",Rincão,10393,8740,84.095064,1653,0.086898,"3543709",
"2126","3150802",Piranga,17088,5648,33.052434,11440,0.065379,"3150802",
"2127","2901007",Amargosa,33455,23463,70.133014,9992,1.044506,"2901007",
"2128","2901106",Amélia Rodrigues,22060,18790,85.176791,3270,-1.275448,"2901106",
"2129","3544004",Rio das Pedras,26324,25071,95.240085,1253,1.638072,"3544004",
"2130","3151107",Pirapetinga,10199,8889,87.155603,1310,0.233277,"3151107",
"2131","2901155",América Dourada,16029,10464,65.281677,5565,0.062543,"2901155",
"2132","2901205",Anagé,25634,4701,18.338925,20933,-2.705599,"2901205",
"2133","3151305",Piraúba,10644,8432,79.218339,2212,-0.648543,"3151305",
"2134","2901304",Andaraí,14051,7644,54.401822,6407,0.170953,"2901304",
"2135","3544251",Rosana,19742,15467,78.345659,4275,-2.883356,"3544251",
"2136","3151404",Pitangui,24410,20497,83.969685,3913,1.320027,"3151404",
"2137","2901353",Andorinha,14116,5601,39.678379,8515,-1.573969,"2901353",
"2138","3151503",Piumhi,30752,27341,88.908039,3411,0.949769,"3151503",
"2139","2901403",Angical,14672,6890,46.960196,7782,-0.028205,"2901403",
"2140","4306007",Crissiumal,14637,5932,40.52743,8705,-0.519023,"4306007",
"2141","3151602",Planura,10275,9976,97.090024,299,3.101699,"3151602",
"2142","3151701",Poço Fundo,15258,9076,59.48355,6182,0.103417,"3151701",
"2143","2901601",Antas,16219,6621,40.822492,9598,2.062709,"2901601",
"2144","2901700",Antônio Cardoso,12067,2581,21.388912,9486,0.540695,"2901700",
"2145","2901809",Antônio Gonçalves,10562,5250,49.706495,5312,1.199836,"2901809",
"2146","4306205",Cruzeiro do Sul,12105,7036,58.124742,5069,0.531571,"4306205",
"2147","3152006",Pompéu,28123,24880,88.468513,3243,1.078257,"3152006",
"2148","2901908",Aporá,17794,7987,44.885917,9807,0.851165,"2901908",
"2149","3545001",Salesópolis,15099,9416,62.361746,5683,0.722467,"3545001",
"2150","2902005",Aracatu,14153,3617,25.556419,10536,-1.282175,"2902005",
"2151","3152170",Ponto dos Volantes,10955,3861,35.244181,7094,0.568217,"3152170",
"2152","2902054",Araças,11637,5887,50.58864,5750,0.803521,"2902054",
"2153","3152204",Porteirinha,36636,18240,49.787095,18396,-0.479644,"3152204",
"2154","3152303",Porto Firme,10331,4817,46.626658,5514,1.244796,"3152303",
"2155","3152402",Poté,14688,8723,59.388617,5965,-0.089161,"3152402",
"2156","2902252",Arataca,10537,4984,47.299991,5553,-0.890678,"2902252",
"2157","4306502",Dom Feliciano,14431,3081,21.349872,11350,1.176007,"4306502",
"2158","2902401",Aurelino Leal,14435,11997,83.110495,2438,-2.43116,"2902401",
"2159","3545605",Santa Adélia,13775,12948,93.99637,827,0.342737,"3545605",
"2160","2902500",Baianópolis,13390,3019,22.546677,10371,1.363425,"2902500",
"2161","4306601",Dom Pedrito,37898,34542,91.144651,3356,-0.912652,"4306601",
"2162","3152808",Prata,24460,18582,75.968929,5878,0.527241,"3152808",
"2163","2902609",Baixa Grande,20907,8118,38.8291,12789,0.322538,"2902609",
"2164","2902658",Banzaê,10850,3625,33.410138,7225,-0.396532,"2902658",
"2165","3546009",Santa Branca,13241,11884,89.751529,1357,0.251742,"3546009",
"2166","2902708",Barra,47386,20942,44.194488,26444,0.998295,"2902708",
"2167","2210003",São João do Piauí,18675,12074,64.65328,6601,0.79338,"2210003",
"2168","2902807",Barra da Estiva,20664,9082,43.950832,11582,-2.369031,"2902807",
"2169","2902906",Barra do Choça,32415,21198,65.39565,11217,-3.239259,"2902906",
"2170","4306809",Encantado,19457,16902,86.868479,2555,0.70136,"4306809",
"2171","2903003",Barra do Mendes,14019,6288,44.853413,7731,0.423878,"2903003",
"2172","4306908",Encruzilhada do Sul,23959,16015,66.843357,7944,0.034033,"4306908",
"2173","3546306",Santa Cruz das Palmeiras,29842,28755,96.357483,1087,2.239635,"3546306",
"2174","3153400",Presidente Olegário,18154,12276,67.621461,5878,0.297018,"3153400",
"2175","3546405",Santa Cruz do Rio Pardo,41409,37602,90.806346,3807,0.170198,"3546405",
"2176","2903235",Barro Alto,13359,6162,46.126207,7197,1.42651,"2903235",
"2177","3546603",Santa Fé do Sul,27572,26343,95.542579,1229,0.561618,"3546603",
"2178","3546702",Santa Gertrudes,18997,18661,98.2313,336,2.569378,"3546702",
"2179","2903409",Belmonte,21296,11491,53.95849,9805,0.87795,"2903409",
"2180","2210409",São Miguel do Tapuio,19137,7010,36.630611,12127,0.24804,"2210409",
"2181","2903508",Belo Campo,15251,8360,54.816078,6891,-2.069346,"2903508",
"2182","2210508",São Pedro do Piauí,12865,7611,59.160513,5254,0.400545,"2210508",
"2183","3154002",Raul Soares,23740,15003,63.197136,8737,-0.324897,"3154002",
"2184","2903607",Biritinga,13867,3070,22.138891,10797,-0.77291,"2903607",
"2185","2210607",São Raimundo Nonato,30739,19571,63.668304,11168,1.929489,"2210607",
"2186","3154101",Recreio,10147,8997,88.666601,1150,-0.05759,"3154101",
"2187","2903706",Boa Nova,15973,5662,35.447317,10311,-3.531411,"2903706",
"2188","2903805",Boa Vista do Tupim,17552,6079,34.63423,11473,-0.677941,"2903805",
"2189","3154200",Resende Costa,10465,8120,77.591973,2345,0.177349,"3154200",
"2190","3154309",Resplendor,16851,13015,77.235772,3836,-0.104683,"3154309",
"2191","2903953",Bom Jesus da Serra,10264,2405,23.431411,7859,-0.326937,"2903953",
"2192","2904001",Boninal,13199,4203,31.843321,8996,0.825349,"2904001",
"2193","2210706",Simões,13694,5508,40.221995,8186,0.076387,"2210706",
"2194","4307500",Espumoso,14806,10492,70.863164,4314,-1.264119,"4307500",
"2195","3547502",Santa Rita do Passa Quatro,26108,23499,90.006894,2609,-0.016405,"3547502",
"2196","2210805",Simplício Mendes,11415,6883,60.297854,4532,0.574914,"2210805",
"2197","2904050",Bonito,13589,5873,43.21878,7716,0.743872,"2904050",
"2198","3547601",Santa Rosa de Viterbo,22630,21615,95.514803,1015,0.77803,"3547601",
"2199","2904100",Boquira,21824,7233,33.142412,14591,-0.192915,"2904100",
"2200","2904209",Botuporã,11008,3706,33.666424,7302,-0.649822,"2904209",
"2201","3547700",Santo Anastácio,20454,19018,92.979368,1436,-0.204356,"3547700",
"2202","2904308",Brejões,12597,4375,34.730491,8222,-2.778746,"2904308",
"2203","4307807",Estrela,28921,24398,84.360845,4523,0.774246,"4307807",
"2204","2904506",Brotas de Macaúbas,10901,3115,28.57536,7786,-2.487476,"2904506",
"2205","3548005",Santo Antônio de Posse,19767,15850,80.184145,3917,1.247385,"3548005",
"2206","2211100",União,41584,19916,47.893421,21668,0.628013,"2211100",
"2207","2211209",Uruçuí,18952,13149,69.38054,5803,1.555535,"2211209",
"2208","2904704",Buerarema,19814,16929,85.439588,2885,0.512142,"2904704",
"2209","2904753",Buritirama,18630,7168,38.475577,11462,0.655615,"2904753",
"2210","2211308",Valença do Piauí,19697,13905,70.594507,5792,-0.137048,"2211308",
"2211","2904803",Caatiba,10360,5608,54.131274,4752,-5.6,"2904803",
"2212","3155504",Rio Paranaíba,10744,6554,61.001489,4190,-1.001118,"3155504",
"2213","2904852",Cabaceiras do Paraguaçu,17454,4056,23.238226,13398,1.666609,"2904852",
"2214","3155603",Rio Pardo de Minas,28566,11183,39.147938,17383,0.682905,"3155603",
"2215","2904902",Cachoeira,31352,16304,52.003062,15048,0.433928,"2904902",
"2216","4308102",Feliz,11647,8799,75.547351,2848,0.412721,"4308102",
"2217","3155702",Rio Piracicaba,14260,11350,79.593268,2910,0.122821,"3155702",
"2218","2905008",Caculé,21805,12308,56.445769,9497,0.999232,"2905008",
"2219","4308201",Flores da Cunha,25223,16338,64.774214,8885,0.907088,"4308201",
"2220","3548609",São Bento do Sapucaí,10435,5014,48.049832,5421,0.110004,"3548609",
"2221","3155801",Rio Pomba,16621,13929,83.803622,2692,0.22724,"3155801",
"2222","2905107",Caém,10345,3558,34.393427,6787,-2.736888,"2905107",
"2223","2905156",Caetanos,12107,2694,22.25159,9413,-1.093897,"2905156",
"2224","2300101",Abaiara,10156,4134,40.705002,6022,2.775244,"2300101",
"2225","4308300",Fontoura Xavier,11036,3818,34.595868,7218,-0.553232,"4308300",
"2226","3156007",Rio Vermelho,14761,5659,38.337511,9102,-0.138592,"3156007",
"2227","2905206",Caetité,46010,25743,55.95088,20267,0.288963,"2905206",
"2228","2300150",Acarapé,14635,7774,53.119235,6861,1.788633,"2300150",
"2229","2905305",Cafarnaum,17317,9777,56.458971,7540,1.083243,"2905305",
"2230","2300309",Acopiara,48571,24401,50.237796,24170,0.429038,"2300309",
"2231","2905404",Cairu,13402,7616,56.827339,5786,2.325394,"2905404",
"2232","4308508",Frederico Westphalen,27080,21333,78.777696,5747,0.170496,"4308508",
"2233","2300408",Aiuaba,15556,3620,23.270764,11936,1.057172,"2300408",
"2234","2905503",Caldeirão Grande,13053,4331,33.180112,8722,1.959571,"2905503",
"2235","4308607",Garibaldi,28707,25508,88.856376,3199,0.185495,"4308607",
"2236","2300507",Alcântaras,10232,3070,30.003909,7162,0.993306,"2300507",
"2237","2905602",Camacan,30187,23754,78.689502,6433,-0.404159,"2905602",
"2238","2905800",Camamu,32048,13369,41.715552,18679,-0.699047,"2905800",
"2239","2300705",Alto Santo,18558,7509,40.462334,11049,2.706303,"2300705",
"2240","3549409",São Joaquim da Barra,43486,42824,98.477671,662,0.639916,"3549409",
"2241","2905909",Campo Alegre de Lourdes,26910,5840,21.70197,21070,-0.364639,"2905909",
"2242","2300754",Amontada,37188,14104,37.926213,23084,2.018644,"2300754",
"2243","4308904",Getúlio Vargas,15790,13227,83.768208,2563,-0.634108,"4308904",
"2244","2906105",Canápolis,10498,3015,28.719756,7483,1.071928,"2906105",
"2245","3156809",Sabinópolis,15839,10056,63.488857,5783,-0.381929,"3156809",
"2246","2300903",Apuiarés,13614,6021,44.226532,7593,1.180848,"2300903",
"2247","4309001",Giruá,16976,12412,73.114986,4564,-1.409118,"4309001",
"2248","3156908",Sacramento,22057,17422,78.986263,4635,0.477249,"3156908",
"2249","2906204",Canarana,24286,11365,46.796508,12921,1.644838,"2906204",
"2250","3157005",Salinas,37269,28221,75.72245,9048,0.212229,"3157005",
"2251","2906303",Canavieiras,35361,28013,79.220045,7348,0.015766,"2906303",
"2252","4309100",Gramado,31305,27867,89.017729,3438,1.302928,"4309100",
"2253","2301208",Aracoiaba,24367,13147,53.954118,11220,0.178914,"2301208",
"2254","3157203",Santa Bárbara,26016,23321,89.64099,2695,1.050997,"3157203",
"2255","2301257",Ararendá,10616,4833,45.525622,5783,0.846095,"2301257",
"2256","3550001",São Luís do Paraitinga,10471,6493,62.009359,3978,0.057433,"3550001",
"2257","2906600",Candiba,12345,6818,55.228838,5527,0.258393,"2906600",
"2258","2301307",Araripe,21176,12833,60.601624,8343,1.106546,"2301307",
"2259","3550100",São Manuel,37532,35912,95.683683,1620,0.381433,"3550100",
"2260","2906709",Cândido Sales,26657,19145,71.819785,7512,-0.958428,"2906709",
"2261","2301406",Aratuba,12048,3028,25.132802,9020,-0.363422,"2301406",
"2262","3550209",São Miguel Arcanjo,30303,19381,63.957364,10922,-0.231204,"3550209",
"2263","2906808",Cansanção,32670,10632,32.543618,22038,0.320211,"2906808",
"2264","2301604",Assaré,21525,10043,46.657375,11482,0.43419,"2301604",
"2265","2906824",Canudos,14586,7617,52.221308,6969,0.835235,"2906824",
"2266","4309407",Guaporé,21243,19250,90.618086,1993,0.819054,"4309407",
"2267","3550407",São Pedro,29596,25003,84.481011,4593,0.848149,"3550407",
"2268","2906857",Capela do Alto Alegre,12300,5901,47.97561,6399,0.475828,"2906857",
"2269","2301703",Aurora,24370,10790,44.275749,13580,-0.481251,"2301703",
"2270","2906873",Capim Grosso,25724,19770,76.854299,5954,1.051364,"2906873",
"2271","2906899",Caraíbas,10493,1935,18.440865,8558,-6.788663,"2906899",
"2272","2301851",Banabuiú,17410,8424,48.385985,8986,1.058442,"2301851",
"2273","2100832",Apicum-Açu,13127,7586,57.789289,5541,2.426342,"2100832",
"2274","5103254",Colniza,27659,15707,56.788026,11952,0,"5103254",
"2275","2703759",Jequiá da Praia,11424,2538,22.216387,8886,8.602988,"2703759",
"2276","2903276",Barrocas,13160,4193,31.861702,8967,0,"2903276",
"2277","2919553",Luís Eduardo magalhães,43794,40220,91.839065,3574,0,"2919553",
"2278","1400050",Alto Alegre,12404,5150,41.518865,7254,-5.110131,"1400050",
"2279","1400159",Bonfim,10171,3611,35.5029,6560,1.24677,"1400159",
"2280","1400175",Cantá,11062,1828,16.525041,9234,3.711969,"1400175",
"2281","1400209",Caracaraí,17446,9744,55.852344,7702,2.895857,"1400209",
"2282","1400308",Mucajaí,12450,7720,62.008032,4730,1.462291,"1400308",
"2283","1600501",Oiapoque,18858,12314,65.298547,6544,5.590624,"1600501",
"2284","2906907",Caravelas,21068,11523,54.694323,9545,0.672052,"2906907",
"2285","1100015",Alta Floresta d'Oeste,23783,13312,55.972754,10471,-1.550964,"1100015",
"2286","4309605",Horizontina,18273,14210,77.765008,4063,0.45699,"4309605",
"2287","3550803",São Sebastião da Grama,12471,8278,66.377997,4193,0.019489,"3550803",
"2288","2301950",Barreira,18388,7188,39.090711,11200,1.107143,"2301950",
"2289","3550902",São Simão,13107,12191,93.011368,916,-0.604209,"3550902",
"2290","3157708",Santa Juliana,10534,8778,83.330169,1756,3.865167,"3157708",
"2291","2907103",Carinhanha,28398,12308,43.34108,16090,0.579648,"2907103",
"2292","2302008",Barro,20640,11989,58.08624,8651,0.445973,"2302008",
"2293","2302057",Barroquinha,14779,9687,65.545707,5092,0.858071,"2302057",
"2294","3157906",Santa Margarida,14165,6775,47.829156,7390,0.464358,"3157906",
"2295","2907301",Castro Alves,24350,13977,57.400411,10373,-0.690972,"2907301",
"2296","2302107",Baturité,31537,22848,72.448235,8689,0.783168,"2302107",
"2297","1100056",Cerejeiras,16237,13585,83.666934,2652,-1.6226,"1100056",
"2298","3158003",Santa Maria de Itabira,10377,6029,58.099643,4348,0.04275,"3158003",
"2299","2302206",Beberibe,45962,19774,43.022497,26188,1.178488,"2302206",
"2300","1100064",Colorado do Oeste,17535,12486,71.206159,5049,-3.120592,"1100064",
"2301","2302305",Bela Cruz,29462,12232,41.517887,17230,0.547093,"2302305",
"2302","2907509",Catu,48471,40139,82.81034,8332,0.523622,"2907509",
"2303","3158201",Santa Maria do Suaçuí,14270,10232,71.702873,4038,-0.079833,"3158201",
"2304","1100080",Costa Marques,13487,7119,52.784163,6368,4.059587,"1100080",
"2305","4310009",Ibirubá,18604,14329,77.021071,4275,-0.022249,"4310009",
"2306","2907608",Central,17284,7965,46.083083,9319,0.413404,"2907608",
"2307","2302503",Brejo Santo,39589,24330,61.456465,15259,0.405229,"2302503",
"2308","1100098",Espigão d'Oeste,27753,19301,69.545635,8452,1.110694,"1100098",
"2309","4310108",Igrejinha,30930,29678,95.95215,1252,2.086568,"4310108",
"2310","3551603",Serra Negra,24555,21239,86.495622,3316,0.416427,"3551603",
"2311","2907707",Chorrochó,10502,2441,23.243192,8061,0.458551,"2907707",
"2312","1100106",Guajará-Mirim,35829,32876,91.758073,2953,-0.853651,"1100106",
"2313","2302701",Campos Sales,25501,18276,71.667778,7225,-0.03636,"2302701",
"2314","2907806",Cícero Dantas,30761,16851,54.780404,13910,-0.080086,"2907806",
"2315","3551801",Sete Barras,12835,6357,49.528633,6478,-0.941842,"3551801",
"2316","2907905",Cipó,15025,10184,67.780366,4841,0.724115,"2907905",
"2317","4310330",Imbé,14868,14826,99.717514,42,2.815163,"4310330",
"2318","3551900",Severínia,14636,13880,94.834654,756,1.048991,"3551900",
"2319","2908002",Coaraci,22682,20516,90.450578,2166,-2.890726,"2908002",
"2320","2302909",Capistrano,16341,5773,35.328315,10568,0.454895,"2302909",
"2321","1100130",Machadinho d'Oeste,31183,16134,51.73973,15049,4.614615,"1100130",
"2322","2908101",Cocos,17295,7612,44.01272,9683,-0.258327,"2908101",
"2323","2303006",Caridade,17927,9629,53.712278,8298,2.002365,"2303006",
"2324","1100148",Nova Brasilândia d'Oeste,16942,7906,46.665093,9036,-0.10496,"1100148",
"2325","3552106",Socorro,32948,21684,65.812796,11264,0.106244,"3552106",
"2326","2303105",Cariré,18464,7779,42.130633,10685,-0.11782,"2303105",
"2327","2908200",Conceição da Feira,19005,12036,63.330702,6969,1.174003,"2908200",
"2328","1100155",Ouro Preto do Oeste,35832,25794,71.985934,10038,-1.866608,"1100155",
"2329","2303204",Caririaçu,26265,11775,44.831525,14490,0.292757,"2303204",
"2330","2908309",Conceição do Almeida,17598,8243,46.84055,9355,-1.023461,"2908309",
"2331","1100189",Pimenta Bueno,32408,27560,85.040731,4848,0.292564,"1100189",
"2332","2303303",Cariús,18614,7659,41.146449,10955,0.131156,"2303303",
"2333","2303402",Carnaubal,15982,7598,47.540984,8384,0.690889,"2303402",
"2334","1100254",Presidente Médici,22087,12877,58.301263,9210,-2.497542,"1100254",
"2335","2908606",Conde,21689,11349,52.326064,10340,0.860778,"2908606",
"2336","2908705",Condeúba,16984,7277,42.846208,9707,-0.863504,"2908705",
"2337","2303600",Catarina,16995,8581,50.491321,8414,1.280291,"2303600",
"2338","1100288",Rolim de Moura,48439,38655,79.8014,9784,0.315681,"1100288",
"2339","3552601",Tabapuã,11168,10187,91.215974,981,0.894609,"3552601",
"2340","2303659",Catunda,10493,5128,48.870676,5365,1.761048,"2303659",
"2341","3552700",Tabatinga,13904,11612,83.515535,2292,0.976115,"3552700",
"2342","2908903",Coração de Maria,23068,8477,36.747876,14591,-0.456032,"2908903",
"2343","4310603",Itaqui,36196,31687,87.542822,4509,-1.336196,"4310603",
"2344","2303808",Cedro,24580,14456,58.812042,10124,0.304739,"2303808",
"2345","1100320",São Miguel do Guaporé,22524,7315,32.47647,15209,-0.828104,"1100320",
"2346","3159605",Santa Rita do Sapucaí,33990,28807,84.751397,5183,1.201433,"3159605",
"2347","2909109",Coribe,14481,5575,38.498722,8906,-0.641236,"2909109",
"2348","2303907",Chaval,12071,8681,71.916163,3390,-0.108408,"2303907",
"2349","1100338",Nova Mamoré,20943,11994,57.269732,8949,5.10706,"1100338",
"2350","2303931",Choró,12714,3494,27.481516,9220,0.827891,"2303931",
"2351","2909208",Coronel João Sá,18037,6649,36.863115,11388,-1.226914,"2909208",
"2352","1100346",Alvorada d'Oeste,16341,8272,50.621137,8069,-2.72809,"1100346",
"2353","3159803",Santa Vitória,15104,12372,81.912076,2732,-1.138968,"3159803",
"2354","2909307",Correntina,31440,12327,39.208015,19113,0.39559,"2909307",
"2355","2303956",Chorozinho,18208,10592,58.172232,7616,-0.385494,"2303956",
"2356","1100379",Alto Alegre dos Parecis,11580,3392,29.291883,8188,-1.319112,"1100379",
"2357","3159902",Santo Antônio do Amparo,17062,15081,88.389403,1981,0.824461,"3159902",
"2358","2909406",Cotegipe,13515,6335,46.873844,7180,0.149936,"2909406",
"2359","2304004",Coreaú,21109,12087,57.259937,9022,0.787624,"2304004",
"2360","1100403",Alto Paraíso,16654,7577,45.496577,9077,3.468291,"1100403",
"2361","3553302",Tambaú,21795,19170,87.955953,2625,-0.299848,"3553302",
"2362","1100452",Buritis,32669,17983,55.046068,14686,3.505494,"1100452",
"2363","4311007",Jaguarão,27751,25421,91.603906,2330,-1.150766,"4311007",
"2364","3553401",Tanabi,23271,20075,86.266168,3196,0.427101,"3553401",
"2365","2909604",Crisópolis,19475,7712,39.599487,11763,0.325488,"2909604",
"2366","4311106",Jaguari,11516,6321,54.88885,5195,-1.150909,"4311106",
"2367","2909703",Cristópolis,13562,3044,22.445067,10518,0.985775,"2909703",
"2368","2304236",Croatá,17302,7063,40.82187,10239,1.066235,"2304236",
"2369","3553609",Tapiratiba,12199,9918,81.301746,2281,-0.84107,"3553609",
"2370","2304251",Cruz,22098,9513,43.049145,12585,1.596413,"2304251",
"2371","3160306",Santo Antônio do Jacinto,11280,6218,55.124113,5062,-1.048804,"3160306",
"2372","1100700",Campo Novo de Rondônia,12367,3101,25.074796,9266,1.090289,"1100700",
"2373","3160405",Santo Antônio do Monte,24660,20877,84.659367,3783,0.707227,"3160405",
"2374","2909901",Curaçá,32354,13007,40.202139,19347,1.65555,"2909901",
"2375","1100809",Candeias do Jamari,16409,9733,59.31501,6676,3.261833,"1100809",
"2376","2910008",Dário Meira,12507,4967,39.71376,7540,-2.76746,"2910008",
"2377","4311205",Júlio de Castilhos,19369,16029,82.75595,3340,-0.749251,"4311205",
"2378","3553807",Taquarituba,22105,19141,86.591269,2964,0.079745,"3553807",
"2379","2910107",Dom Basílio,11084,1716,15.481776,9368,0.876736,"2910107",
"2380","2304301",Farias Brito,19221,8082,42.04776,11139,-0.787683,"2304301",
"2381","1100940",Cujubim,13288,9371,70.522276,3917,10.66775,"1100940",
"2382","3160702",Santos Dumont,45768,39812,86.986541,5956,-0.314689,"3160702",
"2383","2304350",Forquilha,20148,13535,67.177884,6613,2.043311,"2304350",
"2384","1101005",Governador Jorge Teixeira,11389,2506,22.003688,8883,-2.544663,"1101005",
"2385","4311304",Lagoa Vermelha,27209,23438,86.140615,3771,-1.306636,"4311304",
"2386","3553955",Tarumã,12270,11449,93.308883,821,1.916751,"3553955",
"2387","2910404",Encruzilhada,22196,4845,21.828257,17351,-5.477011,"2910404",
"2388","2304459",Fortim,14045,9568,68.123888,4477,2.193349,"2304459",
"2389","1101203",Ministro Andreazza,10308,3245,31.480404,7063,-1.356323,"1101203",
"2390","2304509",Frecheirinha,12780,7056,55.211268,5724,1.107137,"2304509",
"2391","2910503",Entre Rios,38512,23966,62.229954,14546,0.376168,"2910503",
"2392","1101302",Mirante da Serra,12062,6299,52.221854,5763,-1.230451,"1101302",
"2393","3161007",São Domingos do Prata,17288,10119,58.53193,7169,-0.28915,"3161007",
"2394","2910602",Esplanada,30947,19718,63.715384,11229,1.844763,"2910602",
"2395","1101401",Monte Negro,12172,5940,48.800526,6232,-0.522902,"1101401",
"2396","3554300",Teodoro Sampaio,20197,15782,78.140318,4415,0.137978,"3554300",
"2397","2304657",Graça,15275,5691,37.256956,9584,0.439711,"2304657",
"2398","3554508",Tietê,33875,31020,91.571956,2855,0.947968,"3554508",
"2399","2910750",Fátima,18888,6771,35.848158,12117,0.454387,"2910750",
"2400","2304954",Guaiúba,22382,17440,77.919757,4942,1.704967,"2304954",
"2401","2305001",Guaraciaba do Norte,36647,17225,47.002483,19422,0.643877,"2305001",
"2402","2910859",Filadélfia,15928,8417,52.844048,7511,-1.086652,"2910859",
"2403","1101492",São Francisco do Guaporé,15490,8040,51.904454,7450,4.896111,"1101492",
"2404","1101500",Seringueiras,11593,3803,32.804278,7790,-0.076168,"1101500",
"2405","2305209",Hidrolândia,18474,10458,56.609289,8016,0.623858,"2305209",
"2406","2911006",Floresta Azul,10283,7308,71.068754,2975,-1.723815,"2911006",
"2407","2911105",Formosa do Rio Preto,20658,11364,55.010166,9294,1.756063,"2911105",
"2408","2305233",Horizonte,48568,42379,87.257042,6189,5.319518,"2305233",
"2409","4311809",Marau,33720,28678,85.04745,5042,2.503337,"4311809",
"2410","3161809",São Gonçalo do Pará,10253,7798,76.055789,2455,3.665752,"3161809",
"2411","2911204",Gandu,29838,24238,81.231986,5600,1.352456,"2911204",
"2412","2305266",Ibaretama,12673,4171,32.912491,8502,0.126894,"2305266",
"2413","1101708",Urupá,13362,4846,36.267026,8516,-1.525434,"1101708",
"2414","2305308",Ibiapina,23073,9685,41.975469,13388,0.580387,"2305308",
"2415","3555109",Tupi Paulista,12661,10711,84.598373,1950,-0.685986,"3555109",
"2416","3162005",São Gonçalo do Sapucaí,22626,18501,81.768762,4125,0.202409,"3162005",
"2417","2911303",Gentio do Ouro,11267,5602,49.720422,5665,1.469854,"2911303",
"2418","2305332",Ibicuitinga,10975,5588,50.915718,5387,2.183406,"2305332",
"2419","3162104",São Gotardo,30527,28623,93.762898,1904,1.434089,"3162104",
"2420","2911402",Glória,13863,2691,19.411383,11172,-0.697356,"2911402",
"2421","2305357",Icapuí,17720,5515,31.123025,12205,1.422313,"2305357",
"2422","1200013",Acrelândia,11468,5445,47.479944,6023,5.401958,"1200013",
"2423","2911600",Governador Mangabeira,19732,7271,36.848774,12461,2.010942,"2911600",
"2424","1200104",Brasiléia,18992,12175,64.105939,6817,1.584422,"1200104",
"2425","2305605",Independência,25349,10788,42.557892,14561,0.049126,"2305605",
"2426","3162401",São João da Ponte,26007,8303,31.92602,17704,-0.01153,"3162401",
"2427","2305654",Ipaporanga,11346,3589,31.632293,7757,0.125276,"2305654",
"2428","3162450",São João das Missões,10742,2119,19.726308,8623,0.700107,"3162450",
"2429","2911808",Guaratinga,22339,10172,45.534715,12167,-1.205869,"2911808",
"2430","2305704",Ipaumirim,11510,6607,57.402259,4903,-0.035942,"2305704",
"2431","2305803",Ipu,39352,23425,59.526835,15927,0.099866,"2305803",
"2432","2911857",Heliópolis,13998,5751,41.084441,8247,0.942871,"2911857",
"2433","1200252",Epitaciolândia,13392,9191,68.630526,4201,2.813421,"1200252",
"2434","2305902",Ipueiras,37996,18211,47.928729,19785,-0.083563,"2305902",
"2435","2911907",Iaçu,27682,21141,76.370927,6541,-0.415659,"2911907",
"2436","1200302",Feijó,31048,15496,49.909817,15552,2.16667,"1200302",
"2437","2306009",Iracema,14242,9930,69.723353,4312,1.140648,"2306009",
"2438","3556008",Urupês,11858,10449,88.117726,1409,0.030155,"3556008",
"2439","2306108",Irauçuba,21881,13353,61.025547,8528,1.614785,"2306108",
"2440","2912103",Ibicaraí,24597,18310,74.439972,6287,-2.257929,"2912103",
"2441","1200336",Mâncio Lima,13718,8133,59.287068,5585,3.078055,"1200336",
"2442","2912202",Ibicoara,15774,5824,36.921516,9950,1.257281,"2912202",
"2443","3162708",São João do Paraíso,21821,9609,44.035562,12212,0.542528,"3162708",
"2444","2912301",Ibicuí,15618,11558,74.004354,4060,0.455472,"2912301",
"2445","1200351",Marechal Thaumaturgo,12999,3176,24.432649,9823,6.627814,"1200351",
"2446","3556305",Valparaíso,18681,17268,92.436165,1413,0.082094,"3556305",
"2447","3162807",São João Evangelista,15620,9837,62.976953,5783,0.086267,"3162807",
"2448","2912400",Ibipeba,16725,9897,59.174888,6828,1.221799,"2912400",
"2449","2306306",Itapagé,45363,31901,70.323832,13462,1.422291,"2306306",
"2450","1200385",Plácido de Castro,17164,8809,51.322536,8355,1.777943,"1200385",
"2451","3162906",São João Nepomuceno,24875,23480,94.39196,1395,0.641565,"3162906",
"2452","2912509",Ibipitanga,13824,4281,30.967882,9543,0.425683,"2912509",
"2453","3556404",Vargem Grande do Sul,37212,34824,93.582715,2388,0.354318,"3556404",
"2454","2306504",Itapiúna,17501,8380,47.882978,9121,1.042055,"2306504",
"2455","2306553",Itarema,34069,13860,40.682145,20209,1.66645,"2306553",
"2456","2912707",Ibirapitanga,22929,6053,26.398884,16876,0.477519,"2912707",
"2457","1200427",Rodrigues Alves,12358,3667,29.673086,8691,6.233787,"1200427",
"2458","4312500",Mostardas,11852,7838,66.132298,4014,0.236049,"4312500",
"2459","2306603",Itatira,17647,7802,44.211481,9845,1.832067,"2306603",
"2460","2912905",Ibirataia,23556,17686,75.080659,5870,-0.698708,"2912905",
"2461","2306702",Jaguaretama,17811,8187,45.965976,9624,-0.169684,"2306702",
"2462","1200450",Senador Guiomard,18814,11246,59.774636,7568,-0.699102,"1200450",
"2463","2913002",Ibitiara,15780,3175,20.120406,12605,1.272795,"2913002",
"2464","1200500",Sena Madureira,34007,21206,62.35775,12801,2.091452,"1200500",
"2465","3556800",Viradouro,16986,16360,96.314612,626,0.892222,"3556800",
"2466","2913101",Ibititá,18559,8452,45.541247,10107,0.513813,"2913101",
"2467","2306900",Jaguaribe,35123,22381,63.721778,12742,0.024835,"2306900",
"2468","1200609",Tarauacá,31985,16472,51.49914,15513,2.982886,"1200609",
"2469","4312658",Não-Me-Toque,15143,13020,85.980321,2123,0.708323,"4312658",
"2470","2913200",Ibotirama,25156,18620,74.018127,6536,0.585327,"2913200",
"2471","2307007",Jaguaruana,30888,17995,58.258871,12893,0.54495,"2307007",
"2472","1200708",Xapuri,14259,7328,51.392103,6931,2.548432,"1200708",
"2473","2307106",Jardim,25829,7895,30.566418,17934,-0.319436,"2307106",
"2474","1200807",Porto Acre,13640,1834,13.445748,11806,2.572761,"1200807",
"2475","4312708",Nonoai,12247,8973,73.266923,3274,-0.653306,"4312708",
"2476","2913408",Igaporã,14483,7378,50.942484,7105,-0.07278,"2913408",
"2477","1300029",Alvarães,12985,6964,53.631113,6021,0.954032,"1300029",
"2478","2307254",Jijoca de Jericoacoara,15246,4598,30.15873,10648,3.370133,"2307254",
"2479","2913457",Igrapiúna,13205,3887,29.43582,9318,-1.76684,"2913457",
"2480","3163706",São Lourenço,40117,40117,100,0,1.190707,"3163706",
"2481","2913507",Iguaí,27658,14056,50.820739,13602,1.376437,"2913507",
"2482","3557204",Chavantes,12170,10931,89.819228,1239,-0.028141,"3557204",
"2483","2307403",Jucás,22872,12490,54.608255,10382,0.150808,"2307403",
"2484","1300102",Anori,13748,8587,62.459994,5161,2.814923,"1300102",
"2485","2307502",Lavras da Mangabeira,29834,16924,56.727224,12910,-0.638887,"2307502",
"2486","2913705",Inhambupe,34305,14091,41.075645,20214,2.135167,"2913705",
"2487","1300144",Apuí,17176,9224,53.702841,7952,3.107557,"1300144",
"2488","2913804",Ipecaetá,15985,2330,14.576165,13655,-1.97699,"2913804",
"2489","1300201",Atalaia do Norte,13618,5733,42.098693,7885,4.437336,"1300201",
"2490","2913903",Ipiaú,42128,37542,89.114128,4586,-0.49628,"2913903",
"2491","2307635",Madalena,16951,6199,36.570114,10752,1.894648,"2307635",
"2492","1300300",Autazes,29635,12405,41.859288,17230,2.848819,"1300300",
"2493","1300409",Barcelos,24113,6655,27.59922,17458,-0.049667,"1300409",
"2494","4313060",Nova Hartz,16665,14020,84.128413,2645,1.446626,"4313060",
"2495","1300508",Barreirinha,26546,11728,44.179914,14818,2.339209,"1300508",
"2496","2307809",Marco,23081,14026,60.768598,9055,1.760346,"2307809",
"2497","1300607",Benjamin Constant,28889,18255,63.190142,10634,3.170508,"1300607",
"2498","2914307",Iramaia,15063,7553,50.142734,7510,-2.16177,"2914307",
"2499","2307908",Martinópole,10289,7953,77.296142,2336,2.5913,"2307908",
"2500","1300631",Beruri,13764,7768,56.437082,5996,3.203272,"1300631",
"2501","4313201",Nova Petrópolis,17626,12736,72.256893,4890,0.610343,"4313201",
"2502","2914406",Iraquara,22512,5598,24.866738,16914,2.97616,"2914406",
"2503","2308005",Massapê,33152,22578,68.104488,10574,1.644917,"2308005",
"2504","1300680",Boa Vista do Ramos,13032,6566,50.383671,6466,3.159579,"1300680",
"2505","4313300",Nova Prata,22106,18053,81.665611,4053,2.700778,"4313300",
"2506","3164506",São Sebastião do Maranhão,11667,3396,29.10774,8271,0.07738,"3164506",
"2507","2308104",Mauriti,41579,21228,51.054619,20351,-0.278605,"2308104",
"2508","2914505",Irará,24936,9001,36.096407,15935,-0.129375,"2914505",
"2509","1300706",Boca do Acre,29558,17828,60.315312,11730,1.323499,"1300706",
"2510","2308203",Meruoca,12068,6443,53.389128,5625,0.894105,"2308203",
"2511","1300805",Borba,30884,14003,45.340629,16881,1.094047,"1300805",
"2512","2914653",Itabela,24863,19251,77.428307,5612,-0.49731,"2914653",
"2513","2308302",Milagres,27249,11439,41.979522,15810,0.152969,"2308302",
"2514","1300839",Caapiranga,10540,4613,43.766603,5927,2.606021,"1300839",
"2515","2308351",Milhã,14103,6555,46.479472,7548,1.139105,"2308351",
"2516","1300904",Canutama,11430,5804,50.778653,5626,0.897515,"1300904",
"2517","2308377",Miraíma,12123,6200,51.142456,5923,0.860841,"2308377",
"2518","1301001",Carauari,24820,18154,73.142627,6666,0.832254,"1301001",
"2519","3165008",São Tiago,10234,7961,77.789721,2273,-0.015346,"3165008",
"2520","2914901",Itacaré,24519,14165,57.771524,10354,4.415148,"2914901",
"2521","2308401",Missão Velha,33654,14603,43.391573,19051,0.461765,"2308401",
"2522","1301100",Careiro,30792,6697,21.749156,24095,1.599909,"1301100",
"2523","2915007",Itaeté,13780,5593,40.587808,8187,-0.232124,"2915007",
"2524","2308500",Mombaça,44292,18657,42.122731,25635,1.033905,"2308500",
"2525","1301159",Careiro da Várzea,22925,789,3.441658,22136,4.132102,"1301159",
"2526","2308609",Monsenhor Tabosa,16537,8761,52.97817,7776,0.167847,"2308609",
"2527","2915106",Itagi,13851,10114,73.019999,3737,-0.777652,"2915106",
"2528","2915205",Itagibá,16108,9443,58.623044,6665,-0.925264,"2915205",
"2529","1301308",Codajás,15929,11486,72.107477,4443,-1.340357,"1301308",
"2530","4313508",Osório,38378,33749,87.938402,4629,0.865627,"4313508",
"2531","1301407",Eirunepé,29266,20608,70.416183,8658,1.66351,"1301407",
"2532","2915353",Itaguaçu da Bahia,12388,2354,19.00226,10034,1.310359,"2915353",
"2533","2308906",Morrinhos,21065,8866,42.088773,12199,2.330296,"2308906",
"2534","1301506",Envira,16350,9683,59.223242,6667,-2.167088,"1301506",
"2535","4313656",Palmares do Sul,11387,9882,86.783174,1505,0.687189,"4313656",
"2536","2309003",Mucambo,13985,8470,60.564891,5515,0.179016,"2309003",
"2537","1301605",Fonte Boa,19609,12784,65.194554,6825,-6.551055,"1301605",
"2538","4313706",Palmeira das Missões,33553,28332,84.439543,5221,-1.83299,"4313706",
"2539","3165552",Setubinha,10813,2465,22.796634,8348,2.190839,"3165552",
"2540","2915502",Itajuípe,20279,15700,77.419991,4579,-1.480618,"2915502",
"2541","2309102",Mulungu,10956,4064,37.09383,6892,3.018564,"2309102",
"2542","1301654",Guajará,14088,6541,46.429585,7547,0.912604,"1301654",
"2543","2309201",Nova Olinda,12939,7723,59.687766,5216,0.989769,"2309201",
"2544","1301704",Humaitá,38162,27748,72.711074,10414,2.188368,"1301704",
"2545","4313904",Panambi,36233,32557,89.854552,3676,1.516401,"4313904",
"2546","2309300",Nova Russas,30587,22169,72.478504,8418,0.592962,"2309300",
"2547","1301803",Ipixuna,17037,7197,42.243353,9840,2.071658,"1301803",
"2548","2309409",Novo Oriente,27385,13732,50.14424,13653,0.678468,"2309409",
"2549","2915809",Itambé,32497,22127,68.089362,10370,0.745782,"2915809",
"2550","1301852",Iranduba,32378,11898,36.747174,20480,0.033135,"1301852",
"2551","2309458",Ocara,23242,7101,30.552448,16141,1.062876,"2309458",
"2552","2916005",Itanhém,20607,14066,68.258359,6541,-0.494079,"2916005",
"2553","2309508",Orós,21222,15525,73.155216,5697,-0.527873,"2309508",
"2554","4314050",Parobé,48556,46029,94.7957,2527,1.164521,"4314050",
"2555","2916203",Itapé,11116,6700,60.27348,4416,-3.856575,"2916203",
"2556","2916302",Itapebi,11473,9527,83.038438,1946,0.439703,"2916302",
"2557","2309805",Pacoti,11078,4474,40.386351,6604,0.193635,"2309805",
"2558","3166204",Senhora dos Remédios,10189,3451,33.86986,6738,0.233508,"3166204",
"2559","1302306",Jutaí,16878,9645,57.145396,7233,-4.024002,"1302306",
"2560","2916500",Itapicuru,30547,6013,19.684421,24534,1.610408,"2916500",
"2561","1302405",Lábrea,36235,21843,60.281496,14392,3.25541,"1302405",
"2562","2310100",Palmácia,10288,4489,43.633359,5799,0.610332,"2310100",
"2563","2310209",Paracuru,30527,19607,64.228388,10920,1.481376,"2310209",
"2564","1302553",Manaquiri,18991,5085,26.775841,13906,5.903358,"1302553",
"2565","2916807",Itarantim,17541,14347,81.791232,3194,0.513706,"2916807",
"2566","2310258",Paraipaba,28101,13169,46.863101,14932,1.4188,"2310258",
"2567","2310308",Parambu,30515,12849,42.10716,17666,-0.809715,"2310308",
"2568","2916856",Itatim,14510,9611,66.237078,4899,1.921602,"2916856",
"2569","1302702",Manicoré,43916,19465,44.323253,24451,2.073972,"1302702",
"2570","3166808",Serra do Salitre,10154,7462,73.48828,2692,1.12373,"3166808",
"2571","2916906",Itiruçu,15653,11570,73.915543,4083,2.04486,"2916906",
"2572","2310407",Paramoti,11551,5140,44.498312,6411,0.739978,"2310407",
"2573","1302801",Maraã,17450,7043,40.361032,10407,0.307472,"1302801",
"2574","2917003",Itiúba,35594,9448,26.5438,26146,0.020486,"2917003",
"2575","2310506",Pedra Branca,40703,20688,50.82672,20015,-0.013681,"2310506",
"2576","1302900",Maués,46694,23796,50.96158,22898,2.221993,"1302900",
"2577","2917102",Itororó,19985,17758,88.856642,2227,0.133669,"2917102",
"2578","1303007",Nhamundá,17437,7180,41.176808,10257,1.833073,"1303007",
"2579","2917201",Ituaçu,17916,5828,32.529582,12088,0.52766,"2917201",
"2580","2310704",Pentecoste,33665,20339,60.415862,13326,0.460291,"2310704",
"2581","1303106",Nova Olinda do Norte,28969,13103,45.231109,15866,2.893896,"1303106",
"2582","4314506",Pinheiro Machado,12927,9634,74.526186,3293,-1.717822,"4314506",
"2583","3167103",Serro,20746,12304,59.307818,8442,-0.181838,"3167103",
"2584","2917300",Ituberá,23452,16773,71.520553,6679,-0.408085,"2917300",
"2585","2310803",Pereiro,15054,5450,36.203003,9604,-0.161228,"2310803",
"2586","1303205",Novo Airão,14496,10674,73.634106,3822,5.983781,"1303205",
"2587","2917334",Iuiú,11440,5110,44.667832,6330,1.247559,"2917334",
"2588","2310852",Pindoretama,17086,10341,60.523235,6745,1.925172,"2310852",
"2589","1303304",Novo Aripuanã,17903,10760,60.101659,7143,0.641755,"1303304",
"2590","4314605",Piratini,20210,11703,57.906977,8507,0.575695,"4314605",
"2591","2310902",Piquet Carneiro,14712,6459,43.902936,8253,1.637369,"2310902",
"2592","4314704",Planalto,10577,5597,52.916706,4980,-0.942641,"4314704",
"2593","2917409",Jacaraci,14308,4659,32.562203,9649,0.812551,"2917409",
"2594","1303502",Pauini,18152,8959,49.355443,9193,0.86328,"1303502",
"2595","2311009",Poranga,11791,7698,65.287083,4093,0.065597,"2311009",
"2596","1303536",Presidente Figueiredo,23077,11095,48.078173,11982,4.121396,"1303536",
"2597","2917607",Jaguaquara,46529,36494,78.432805,10035,-0.028215,"2917607",
"2598","2311108",Porteiras,14775,5090,34.450085,9685,-0.825792,"2311108",
"2599","1303569",Rio Preto da Eva,24403,12402,50.82162,12001,4.79469,"1303569",
"2600","2917706",Jaguarari,29023,14893,51.314475,14130,0.819162,"2917706",
"2601","1303601",Santa Isabel do Rio Negro,16746,6242,37.274573,10504,6.807282,"1303601",
"2602","2917805",Jaguaripe,16101,5319,33.035215,10782,2.633893,"2917805",
"2603","1303700",Santo Antônio do Içá,29118,11642,39.982142,17476,0.452071,"1303700",
"2604","3168002",Taiobeiras,29625,23892,80.648101,5733,1.149583,"3168002",
"2605","2311264",Quiterianópolis,20044,5935,29.609858,14109,1.265481,"2311264",
"2606","1303809",São Gabriel da Cachoeira,38576,16656,43.177105,21920,3.683375,"1303809",
"2607","1303908",São Paulo de Olivença,30609,12605,41.180698,18004,4.094443,"1303908",
"2608","2311355",Quixelô,15678,4695,29.946422,10983,0.074942,"2311355",
"2609","2918100",Jeremoabo,37199,16701,44.896368,20498,0.908916,"2918100",
"2610","2918209",Jiquiriçá,13310,5182,38.933133,8128,-0.347173,"2918209",
"2611","4315107",Porto Xavier,10803,5384,49.838008,5419,-0.501547,"4315107",
"2612","2918308",Jitaúna,16689,9051,54.233327,7638,-3.265987,"2918308",
"2613","2311504",Quixeré,18612,11092,59.59596,7520,1.420624,"2311504",
"2614","1304062",Tabatinga,44946,30664,68.224091,14282,2.45844,"1304062",
"2615","4100509",Altônia,19724,14001,70.984587,5723,0.363009,"4100509",
"2616","3168408",Tarumirim,14103,7697,54.57704,6406,-0.38402,"3168408",
"2617","2918357",João Dourado,20767,12883,62.035922,7884,1.303632,"2918357",
"2618","2311603",Redenção,25647,14741,57.476508,10906,0.369693,"2311603",
"2619","1304104",Tapauá,19250,9897,51.412987,9353,-0.960179,"1304104",
"2620","4100608",Alto Paraná,12906,10538,81.651945,2368,0.210974,"4100608",
"2621","3168507",Teixeiras,11585,7483,64.592145,4102,0.549524,"3168507",
"2622","2311702",Reriutaba,19270,9822,50.97042,9448,-1.370284,"2311702",
"2623","4100707",Alto Piquiri,10060,8368,83.180915,1692,-0.957689,"4100707",
"2624","2918456",Jucuruçu,10527,1854,17.611855,8673,-2.286267,"2918456",
"2625","1304237",Tonantins,19049,6257,32.846869,12792,2.97777,"1304237",
"2626","2918506",Jussara,14820,9444,63.724696,5376,-0.490521,"2918506",
"2627","2311900",Saboeiro,16225,8325,51.309707,7900,-0.00088,"2311900",
"2628","2311959",Salitre,15784,5814,36.834769,9970,1.806276,"2311959",
"2629","1304302",Urucará,15639,10724,68.572159,4915,-2.274589,"1304302",
"2630","4315305",Quaraí,22444,20553,91.574586,1891,-0.954188,"4315305",
"2631","4101002",Ampére,16996,11607,68.292539,5389,1.21061,"4101002",
"2632","2312007",Santana do Acaraú,28526,14281,50.0631,14245,1.22361,"2312007",
"2633","1304401",Urucurituba,17030,8629,50.669407,8401,4.801845,"1304401",
"2634","3169000",Tocantins,15631,12397,79.310345,3234,0.585603,"3169000",
"2635","2312106",Santana do Cariri,17523,8920,50.904525,8603,0.563607,"2312106",
"2636","4101101",Andirá,21255,19772,93.022818,1483,-0.271254,"4101101",
"2637","2918753",Lagoa Real,13773,2727,19.799608,11046,1.091674,"2918753",
"2638","2312205",Santa Quitéria,42886,20707,48.283822,22179,0.171388,"2312205",
"2639","1400050",Alto Alegre,12404,5150,41.518865,7254,-5.110131,"1400050",
"2640","2312304",São Benedito,42956,23245,54.113512,19711,1.062034,"2312304",
"2641","2918803",Laje,21048,5702,27.09046,15346,1.022694,"2918803",
"2642","4101200",Antonina,17537,14658,83.583281,2879,-1.266797,"4101200",
"2643","2312403",São Gonçalo do Amarante,40108,25041,62.433928,15067,1.714612,"2312403",
"2644","1400159",Bonfim,10171,3611,35.5029,6560,1.24677,"1400159",
"2645","4315503",Restinga Seca,15574,8792,56.453063,6782,-0.735545,"4315503",
"2646","1400175",Cantá,11062,1828,16.525041,9234,3.711969,"1400175",
"2647","3169356",Três Marias,25809,24306,94.17645,1503,1.306076,"3169356",
"2648","2312601",São Luís do Curu,12027,7810,64.937225,4217,0.645905,"2312601",
"2649","1400209",Caracaraí,17446,9744,55.852344,7702,2.895857,"1400209",
"2650","2312700",Senador Pompeu,25199,14800,58.732489,10399,-1.098654,"2312700",
"2651","2919108",Lamarão,11947,1914,16.020758,10033,3.292621,"2919108",
"2652","4315701",Rio Pardo,37408,25702,68.707228,11706,-0.142394,"4315701",
"2653","4101606",Arapoti,25535,18449,72.249853,7086,0.959449,"4101606",
"2654","2919157",Lapão,25492,9838,38.5925,15654,0.436219,"2919157",
"2655","3169604",Tupaciguara,22783,20586,90.356845,2197,-0.207693,"3169604",
"2656","1400308",Mucajaí,12450,7720,62.008032,4730,1.462291,"1400308",
"2657","4101705",Araruna,12631,9524,75.401789,3107,-0.498847,"4101705",
"2658","3169703",Turmalina,17183,11824,68.812198,5359,1.339321,"3169703",
"2659","2313005",Solonópole,17304,8106,46.84466,9198,0.336361,"2313005",
"2660","2919405",Licínio de Almeida,12670,6165,48.658248,6505,0.367271,"2919405",
"2661","2313104",Tabuleiro do Norte,28176,17282,61.335889,10894,0.55885,"2313104",
"2662","4316006",Rolante,19162,14701,76.719549,4461,1.017566,"4316006",
"2663","2919504",Livramento de Nossa Senhora,42056,18975,45.118414,23081,1.449813,"2919504",
"2664","2313203",Tamboril,25411,13203,51.957814,12208,-0.312018,"2313203",
"2665","1400472",Rorainópolis,23482,9790,41.691508,13692,4.381358,"1400472",
"2666","4101903",Assaí,16080,13031,81.038557,3049,-1.633544,"4101903",
"2667","3170057",Ubaporanga,11979,6032,50.354788,5947,0.3593,"3170057",
"2668","2919603",Macajuba,11169,6917,61.930343,4252,-0.384139,"2919603",
"2669","4102000",Assis Chateaubriand,32065,27640,86.199906,4425,-0.545687,"4102000",
"2670","2919702",Macarani,15922,12031,75.562115,3891,1.251934,"2919702",
"2671","4102109",Astorga,24094,21152,87.789491,2942,0.27394,"4102109",
"2672","2919801",Macaúbas,45903,14609,31.825807,31294,1.344539,"2919801",
"2673","2313351",Tejuçuoca,15034,5120,34.056139,9914,1.528974,"2313351",
"2674","4102307",Balsa Nova,10623,3940,37.089334,6683,0.648555,"4102307",
"2675","2313500",Trairi,48501,15111,31.156059,33390,1.228755,"2313500",
"2676","4316451",Salto do Jacuí,12059,10151,84.177793,1908,-1.010999,"4316451",
"2677","4102406",Bandeirantes,32197,27701,86.035966,4496,-0.66313,"4102406",
"2678","2313559",Tururu,13340,5431,40.712144,7909,2.145462,"2313559",
"2679","4102505",Barbosa Ferraz,13423,10090,75.169485,3333,-0.710523,"4102505",
"2680","1500206",Acará,47227,10776,22.817456,36451,-1.400079,"1500206",
"2681","3170503",Urucânia,10170,7534,74.080629,2636,-0.284692,"3170503",
"2682","2313609",Ubajara,29481,14119,47.891863,15362,1.212966,"2313609",
"2683","1500305",Afuá,30946,8894,28.740386,22052,0.683526,"1500305",
"2684","3170529",Urucuia,11278,5894,52.261039,5384,2.305161,"3170529",
"2685","2920106",Mairi,19221,10590,55.095989,8631,-0.626172,"2920106",
"2686","4316600",Sananduva,14653,9671,66.000136,4982,-0.088406,"4316600",
"2687","1500347",Água Azul do Norte,28429,4491,15.797249,23938,3.673825,"1500347",
"2688","2920205",Malhada,16050,6856,42.716511,9194,0.394216,"2920205",
"2689","2313757",Umirim,18162,10679,58.79859,7483,0.661356,"2313757",
"2690","2313807",Uruburetama,19155,12962,67.669016,6193,2.203981,"2313807",
"2691","1500503",Almeirim,30213,18328,60.662629,11885,-1.655047,"1500503",
"2692","4102802",Bela Vista do Paraíso,14849,13605,91.622331,1244,-0.17388,"4102802",
"2693","2920403",Manoel Vitorino,14219,6595,46.381602,7624,-2.274717,"2920403",
"2694","2313906",Uruoca,12967,7237,55.810905,5730,1.756511,"2313906",
"2695","4102901",Bituruna,16098,7444,46.241769,8654,0.328175,"4102901",
"2696","2920452",Mansidão,11638,3854,33.115656,7784,0.748606,"2920452",
"2697","2313955",Varjota,17073,13840,81.063668,3233,0.408222,"2313955",
"2698","1500701",Anajás,24652,9952,40.36995,14700,4.330509,"1500701",
"2699","2920502",Maracás,34113,22530,66.045203,11583,1.061282,"2920502",
"2700","2314003",Várzea Alegre,37682,21952,58.255931,15730,1.124874,"2314003",
"2701","3170800",Várzea da Palma,34145,29914,87.608727,4231,1.093975,"3170800",
"2702","2920601",Maragogipe,41879,22368,53.411017,19511,0.545564,"2920601",
"2703","1500859",Anapu,17619,7412,42.068222,10207,9.378729,"1500859",
"2704","3170909",Varzelândia,19022,9234,48.543791,9788,-0.109914,"3170909",
"2705","2920700",Maraú,16849,3458,20.523473,13391,-1.224016,"2920700",
"2706","2400109",Acari,10851,8512,78.444383,2339,-0.43724,"2400109",
"2707","3171006",Vazante,19070,15480,81.17462,3590,0.10683,"3171006",
"2708","1500909",Augusto Corrêa,36241,16599,45.801716,19642,1.342507,"1500909",
"2709","2920809",Marcionílio Souza,10647,5356,50.30525,5291,-0.170575,"2920809",
"2710","1500958",Aurora do Pará,21121,6461,30.590408,14660,0.979464,"1500958",
"2711","2920908",Mascote,16020,12384,77.303371,3636,-0.064928,"2920908",
"2712","2400307",Afonso Bezerra,10329,5770,55.862136,4559,-0.722736,"2400307",
"2713","1501006",Aveiro,18791,3501,18.63126,15290,2.771678,"1501006",
"2714","4317301",Santa Vitória do Palmar,30932,27023,87.362602,3909,-1.049967,"4317301",
"2715","1501105",Bagre,18523,7743,41.802084,10780,4.394291,"1501105",
"2716","2921054",Matina,12282,4080,33.219345,8202,2.628785,"2921054",
"2717","2400505",Alexandria,13710,8906,64.959883,4804,-0.064437,"2400505",
"2718","4317400",Santiago,49193,44628,90.720224,4565,-0.82717,"4317400",
"2719","1501204",Baião,26017,14185,54.522043,11832,3.024509,"1501204",
"2720","2921104",Medeiros Neto,21739,16479,75.803855,5260,0.335664,"2921104",
"2721","2921203",Miguel Calmon,27149,15876,58.477292,11273,-0.574839,"2921203",
"2722","2400703",Alto do Rodrigues,11370,7402,65.101143,3968,2.601723,"2400703",
"2723","2921302",Milagres,11758,9560,81.306345,2198,-0.369894,"2921302",
"2724","2400802",Angicos,11184,9535,85.255722,1649,-0.552181,"2400802",
"2725","4317608",Santo Antônio da Patrulha,37731,26346,69.825873,11385,0.266334,"4317608",
"2726","2921401",Mirangaba,17436,7509,43.06607,9927,2.913176,"2921401",
"2727","4317707",Santo Antônio das Missões,11844,6865,57.961837,4979,-0.981886,"4317707",
"2728","1501451",Belterra,12653,5419,42.827788,7234,-2.018159,"1501451",
"2729","2401008",Apodi,34502,16770,48.605878,17732,0.136553,"2401008",
"2730","4103453",Cafelândia,13011,10664,81.961417,2347,2.238744,"4103453",
"2731","3171600",Virgem da Lapa,14084,6728,47.77052,7356,0.425036,"3171600",
"2732","2401107",Areia Branca,24296,19455,80.074909,4841,1.083889,"2401107",
"2733","4317806",Santo Augusto,13525,10630,78.595194,2895,-0.917088,"4317806",
"2734","1501576",Bom Jesus do Tocantins,12688,7362,58.023329,5326,-0.461979,"1501576",
"2735","2401206",Arês,12166,7326,60.216998,4840,1.031124,"2401206",
"2736","4317905",Santo Cristo,14203,7043,49.588115,7160,-0.672537,"4317905",
"2737","1501600",Bonito,11245,3516,31.26723,7729,1.963509,"1501600",
"2738","3171808",Virginópolis,10813,6132,56.709516,4681,-0.018483,"3171808",
"2739","2921708",Morro do Chapéu,33861,19131,56.498627,14730,-0.264243,"2921708",
"2740","4103602",Cambará,23846,19261,80.772457,4585,0.680749,"4103602",
"2741","2921807",Mortugaba,13888,5961,42.921947,7927,1.402416,"2921807",
"2742","1501725",Brasil Novo,18669,7680,41.137715,10989,1.18355,"1501725",
"2743","3172004",Visconde do Rio Branco,34468,28182,81.762794,6286,0.800047,"3172004",
"2744","2921906",Mucugê,14006,4074,29.087534,9932,0.334913,"2921906",
"2745","2401453",Baraúna,23077,14343,62.152793,8734,2.876468,"2401453",
"2746","2922003",Mucuri,32855,24086,73.309998,8769,2.278244,"2922003",
"2747","4318101",São Francisco de Assis,19445,13390,68.86089,6055,-0.964514,"4318101",
"2748","4103909",Campina da Lagoa,15815,12642,79.936769,3173,-1.04186,"4103909",
"2749","1501782",Breu Branco,46857,23591,50.3468,23266,5.390606,"1501782",
"2750","2922052",Mulungu do Morro,13730,6515,47.450838,7215,-1.367267,"2922052",
"2751","4318200",São Francisco de Paula,21124,13102,62.024238,8022,0.983706,"4318200",
"2752","3167608",Simonésia,17221,6819,39.597004,10402,0.290368,"3167608",
"2753","2922102",Mundo Novo,23720,12711,53.58769,11009,1.567587,"2922102",
"2754","1501907",Bujaru,22474,8219,36.571149,14255,0.951844,"1501907",
"2755","3129707",Ibiraci,10607,7079,66.738946,3528,0.519736,"3129707",
"2756","4318408",São Jerônimo,20358,15608,76.667649,4750,0.05274,"4318408",
"2757","1501956",Cachoeira do Piriá,17444,3847,22.053428,13597,1.761456,"1501956",
"2758","3139003",Machado,37372,30276,81.012523,7096,0.991947,"3139003",
"2759","2401800",Brejinho,11113,8369,75.308198,2744,1.067408,"2401800",
"2760","1502004",Cachoeira do Arari,18907,7524,39.794785,11383,2.613553,"1502004",
"2761","2922300",Muritiba,27167,17151,63.131741,10016,-1.705768,"2922300",
"2762","3170008",Ubaí,11740,5619,47.86201,6121,1.234211,"3170008",
"2763","2922409",Mutuípe,21085,9208,43.670856,11877,0.429382,"2922409",
"2764","1502152",Canaã dos Carajás,23420,17889,76.383433,5531,11.513228,"1502152",
"2765","2922508",Nazaré,26380,23107,87.592873,3273,0.008126,"2922508",
"2766","3154903",Rio Casca,14353,11285,78.624678,3068,-0.871552,"3154903",
"2767","2922607",Nilo Peçanha,12438,3004,24.151793,9434,1.492202,"2922607",
"2768","2402105",Campo Redondo,10435,5435,52.084332,5000,1.814165,"2402105",
"2769","4104402",Cândido de Abreu,17419,4607,26.448131,12812,-1.080256,"4104402",
"2770","3200102",Afonso Cláudio,30674,14736,48.040686,15938,-0.705278,"3200102",
"2771","2922656",Nordestina,12101,3576,29.551277,8525,0.360485,"2922656",
"2772","2402204",Canguaretama,28575,18699,65.43832,9876,0.807356,"2402204",
"2773","4104428",Candói,14973,6262,41.821946,8711,0.775326,"4104428",
"2774","2922706",Nova Canaã,18766,8500,45.294682,10266,2.896726,"2922706",
"2775","2402303",Caraúbas,19618,12931,65.913957,6687,0.60265,"2402303",
"2776","4104451",Cantagalo,12327,7848,63.665125,4479,-0.547555,"4104451",
"2777","1502509",Chaves,19276,1940,10.064329,17336,1.515197,"1502509",
"2778","3200169",Água Doce do Norte,11759,6488,55.17476,5271,-1.150344,"3200169",
"2779","4104501",Capanema,17960,10011,55.740535,7949,-0.219973,"4104501",
"2780","4318507",São José do Norte,24851,18647,75.03521,6204,0.621646,"4318507",
"2781","1502608",Colares,10922,3424,31.34957,7498,0.38518,"1502608",
"2782","3200201",Alegre,30262,19783,65.372414,10479,-0.66727,"3200201",
"2783","4104600",Capitão Leônidas Marques,13486,9786,72.564141,3700,-0.909802,"4104600",
"2784","1502707",Conceição do Araguaia,44680,30932,69.230081,13748,0.420728,"1502707",
"2785","3200300",Alfredo Chaves,13944,6433,46.134538,7511,0.340632,"3200300",
"2786","4104659",Carambeí,16411,12531,76.357321,3880,1.428374,"4104659",
"2787","1502756",Concórdia do Pará,21329,12105,56.753716,9224,0.252356,"1502756",
"2788","2402709",Cerro Corá,10889,5013,46.037285,5876,0.06577,"2402709",
"2789","1502764",Cumaru do Norte,10354,2476,23.913463,7878,8.163042,"1502764",
"2790","4104709",Carlópolis,13101,8575,65.453019,4526,-0.22049,"4104709",
"2791","3200409",Anchieta,19314,13553,70.171896,5761,0.102491,"3200409",
"2793","4318804",São Lourenço do Sul,42216,23081,54.673583,19135,-0.48941,"4318804",
"2794","1502772",Curionópolis,17596,12043,68.441691,5553,-1.446925,"1502772",
"2795","2923001",Nova Viçosa,34479,26985,78.265031,7494,1.037377,"2923001",
"2796","4318903",São Luiz Gonzaga,33996,30097,88.531004,3899,-2.139617,"4318903",
"2797","1502806",Curralinho,25366,8969,35.358354,16397,3.441875,"1502806",
"2798","2923035",Novo Horizonte,10167,3157,31.051441,7010,2.587858,"2923035",
"2799","1502855",Curuá,11802,5028,42.602949,6774,3.583577,"1502855",
"2800","4319000",São Marcos,19595,16702,85.23603,2893,0.473237,"4319000",
"2801","2923050",Novo Triunfo,14133,6114,43.260454,8019,0.551748,"2923050",
"2802","2403103",Currais Novos,41978,37281,88.810806,4697,0.410615,"2403103",
"2803","4105102",Centenário do Sul,11047,9182,83.117588,1865,-0.957957,"4105102",
"2804","1502905",Curuçá,33685,12985,38.548315,20700,3.677745,"1502905",
"2805","3200805",Baixo Guandu,28502,21443,75.233317,7059,0.347101,"3200805",
"2806","2923100",Olindina,23740,12343,51.992418,11397,-0.101285,"2923100",
"2807","4105201",Cerro Azul,17577,5708,32.474256,11869,1.037358,"4105201",
"2808","1502939",Dom Eliseu,38017,26102,68.658758,11915,-0.55561,"1502939",
"2809","2923209",Oliveira dos Brejinhos,22533,6545,29.046288,15988,0.559446,"2923209",
"2810","3200904",Barra de São Francisco,39201,24541,62.602995,14660,0.598613,"3200904",
"2811","4105300",Céu Azul,10873,7925,72.886968,2948,0.575353,"4105300",
"2812","1502954",Eldorado dos Carajás,28273,15141,53.55286,13132,-0.656937,"1502954",
"2813","3201001",Boa Esperança,12854,9435,73.401276,3419,-0.884731,"3201001",
"2814","1503002",Faro,17243,12985,75.305921,4258,8.037046,"1503002",
"2815","4105409",Chopinzinho,19030,10889,57.220179,8141,-1.086958,"4105409",
"2816","2923357",Ourolândia,16262,5400,33.206248,10862,0.822288,"2923357",
"2817","1503044",Floresta do Araguaia,14912,6046,40.544528,8866,0.616553,"1503044",
"2818","2923407",Palmas de Monte Alto,21046,8367,39.755773,12679,0.659889,"2923407",
"2819","3201159",Brejetuba,10891,2755,25.296116,8136,-1.002659,"3201159",
"2820","2403509",Espírito Santo,10109,5099,50.440202,5010,-0.828244,"2403509",
"2821","4105607",Cidade Gaúcha,10442,8581,82.177744,1861,1.312633,"4105607",
"2822","1503077",Garrafão do Norte,24575,8907,36.244151,15668,0.207496,"1503077",
"2823","4105706",Clevelândia,17455,14550,83.357204,2905,-0.70251,"4105706",
"2824","1503093",Goianésia do Pará,26873,18457,68.682321,8416,2.449785,"1503093",
"2825","2923605",Paramirim,19991,8997,45.005252,10994,0.78895,"2923605",
"2826","4319406",São Pedro do Sul,16546,11817,71.419074,4729,-0.376741,"4319406",
"2827","1503101",Gurupá,24279,7281,29.988879,16998,0.714911,"1503101",
"2828","2923704",Paratinga,28634,9557,33.376406,19077,0.485759,"2923704",
"2829","3201407",Castelo,32199,19092,59.293767,13107,-0.244711,"3201407",
"2830","4105904",Colorado,20892,19187,91.838981,1705,-0.044367,"4105904",
"2831","4319505",São Sebastião do Caí,20322,16284,80.129908,4038,0.445065,"4319505",
"2832","1503200",Igarapé-Açu,33633,19768,58.775607,13865,0.534987,"1503200",
"2833","2923803",Paripiranga,28303,8978,31.721019,19325,0.895341,"2923803",
"2834","4319604",São Sepé,23633,18422,77.950324,5211,-0.583373,"4319604",
"2835","3201605",Conceição da Barra,26045,18731,71.917835,7314,-0.24388,"3201605",
"2836","2923902",Pau Brasil,12133,8047,66.323251,4086,-1.03328,"2923902",
"2837","3201704",Conceição do Castelo,11218,5365,47.824924,5853,0.398504,"3201704",
"2838","4106209",Contenda,14549,7879,54.154925,6670,1.35487,"4106209",
"2839","1503457",Ipixuna do Pará,38870,9916,25.510677,28954,6.424237,"1503457",
"2840","2924058",Pé de Serra,14147,4994,35.30077,9153,0.638016,"2924058",
"2841","4106308",Corbélia,15382,13036,84.748407,2346,-0.384997,"4106308",
"2842","1503507",Irituia,29585,6461,21.83877,23124,-0.442578,"1503507",
"2843","3201902",Domingos Martins,31138,7821,25.11722,23317,0.268498,"3201902",
"2844","2404200",Goianinha,20276,14300,70.526731,5976,1.992142,"2404200",
"2845","4106407",Cornélio Procópio,46638,43593,93.470989,3045,-0.068121,"4106407",
"2846","2924207",Pedro Alexandre,16892,2607,15.433341,14285,-0.051482,"2924207",
"2847","2404309",Governador Dix-Sept Rosado,12308,6469,52.559311,5839,0.638108,"2404309",
"2848","1503705",Itupiranga,41611,18363,44.130158,23248,-2.493173,"1503705",
"2849","2924306",Piatã,18017,7180,39.851252,10837,-0.738856,"2924306",
"2850","3202108",Ecoporanga,23122,14026,60.660842,9096,-0.518564,"3202108",
"2851","1503754",Jacareacanga,34310,5600,16.321772,28710,5.223022,"1503754",
"2852","4106506",Coronel Vivida,21183,14428,68.111221,6755,-1.355189,"4106506",
"2853","2924405",Pilão Arcado,32124,9734,30.301332,22390,0.64374,"2924405",
"2854","3202207",Fundão,15114,12901,85.357946,2213,2.16569,"3202207",
"2855","2404507",Guamaré,11499,4222,36.716236,7277,5.042514,"2404507",
"2856","2924504",Pindaí,15294,3946,25.800968,11348,-0.185432,"2924504",
"2857","3202306",Guaçuí,25650,19721,76.88499,5929,0.088309,"3202306",
"2858","2404606",Ielmo Marinho,11551,1421,12.301965,10130,1.723133,"2404606",
"2859","1503903",Juruti,33559,12363,36.839596,21196,1.047608,"1503903",
"2860","4320107",Sarandi,20159,16654,82.613225,3505,1.501436,"4320107",
"2861","2924603",Pindobaçu,20041,10793,53.854598,9248,-0.576683,"2924603",
"2862","2404705",Ipanguaçu,13412,5092,37.966001,8320,1.694143,"2404705",
"2863","4320206",Seberi,10816,5651,52.246672,5165,-0.684832,"4320206",
"2864","4106605",Cruzeiro do Oeste,20000,16976,84.88,3024,-0.157574,"4106605",
"2865","1504000",Limoeiro do Ajuru,23251,5939,25.542987,17312,2.497199,"1504000",
"2866","3202454",Ibatiba,19612,11836,60.350806,7776,0.296305,"3202454",
"2867","2924652",Pintadas,10543,5095,48.325903,5448,-0.509763,"2924652",
"2868","1504059",Mãe do Rio,27532,22222,80.713352,5310,1.185989,"1504059",
"2869","3202504",Ibiraçu,10289,7474,72.640684,2815,0.204374,"3202504",
"2870","4106803",Cruz Machado,18214,4020,22.070934,14194,0.436551,"4106803",
"2871","2924702",Piripá,13467,6564,48.741368,6903,-2.54303,"2924702",
"2872","3202603",Iconha,11457,6250,54.551802,5207,-0.02989,"3202603",
"2873","2924801",Piritiba,24128,15098,62.574602,9030,3.443513,"2924801",
"2874","1504307",Maracanã,28227,11173,39.582669,17054,0.336486,"1504307",
"2875","3202652",Irupi,10282,3764,36.607664,6518,-0.099638,"3202652",
"2876","1504406",Marapanim,26579,9235,34.745476,17344,1.042391,"1504406",
"2877","3202702",Itaguaçu,13810,7429,53.794352,6381,-0.689197,"3202702",
"2878","2925006",Planalto,21464,13768,64.144614,7696,-0.160695,"2925006",
"2879","4320404",Serafina Corrêa,13404,11115,82.923008,2289,3.006318,"4320404",
"2880","3202801",Itapemirim,30623,19530,63.775594,11093,1.225082,"3202801",
"2881","2925105",Poções,44628,32509,72.844403,12119,0.133555,"2925105",
"2882","1504455",Medicilândia,22392,7953,35.517149,14439,0.663543,"1504455",
"2883","3202900",Itarana,10543,3807,36.109267,6736,-1.141179,"3202900",
"2884","2925204",Pojuca,29977,26096,87.053408,3881,1.94083,"2925204",
"2885","4107207",Dois Vizinhos,33898,25073,73.966016,8825,0.832845,"4107207",
"2886","1504505",Melgaço,17716,3999,22.572816,13717,-2.442494,"1504505",
"2887","3203007",Iúna,25455,15031,59.049303,10424,-0.363378,"3203007",
"2888","2925253",Ponto Novo,14794,7878,53.251318,6916,-2.119105,"2925253",
"2889","1504604",Mocajuba,23211,16531,71.220542,6680,1.760383,"1504604",
"2890","3203056",Jaguaré,21829,13304,60.946447,8525,1.595841,"3203056",
"2891","2405603",Jardim de Piranhas,13668,10565,77.297337,3103,1.883967,"2405603",
"2892","3203106",Jerônimo Monteiro,10673,7928,74.280896,2745,0.665181,"3203106",
"2893","2925402",Potiraguá,10327,6550,63.425971,3777,-4.806645,"2925402",
"2894","2405702",Jardim do Seridó,11966,9533,79.667391,2433,-0.08922,"2405702",
"2895","4107504",Engenheiro Beltrão,13831,11421,82.575374,2410,-0.256598,"4107504",
"2896","3203130",João Neiva,14395,11759,81.688086,2636,-0.86817,"3203130",
"2897","2925501",Prado,24751,14477,58.490566,10274,-0.969603,"2925501",
"2898","2405801",João Câmara,30340,20899,68.882663,9441,0.525027,"2405801",
"2899","1504901",Muaná,28672,10931,38.124302,17741,1.707813,"1504901",
"2900","2925600",Presidente Dutra,13742,8196,59.641974,5546,0.012481,"2925600",
"2901","3203163",Laranja da Terra,10741,2992,27.855879,7749,-0.254091,"3203163",
"2902","4320677",Sinimbu,10209,1361,13.331374,8848,-0.001399,"4320677",
"2903","1504950",Nova Esperança do Piriá,22197,7760,34.959679,14437,2.329076,"1504950",
"2904","2925709",Presidente Jânio Quadros,14768,3858,26.124052,10910,-2.02765,"2925709",
"2905","4320701",Sobradinho,13991,11102,79.351011,2889,-2.182505,"4320701",
"2906","1504976",Nova Ipixuna,14028,7923,56.479897,6105,2.419933,"1504976",
"2907","3203304",Mantenópolis,11376,6983,61.383615,4393,-0.995187,"3203304",
"2908","2925758",Presidente Tancredo Neves,22440,8060,35.918004,14380,2.098368,"2925758",
"2909","2406106",Jucurutu,17429,10456,59.991967,6973,0.090488,"2406106",
"2910","4320800",Soledade,29554,23299,78.835352,6255,-0.083346,"4320800",
"2911","1505007",Nova Timboteua,12085,4664,38.593297,7421,0.8295,"1505007",
"2912","3203320",Marataízes,31000,24002,77.425806,6998,0.1843,"3203320",
"2913","2925808",Queimadas,26968,12971,48.097745,13997,1.313932,"2925808",
"2914","1505031",Novo Progresso,21509,17535,81.524013,3974,-2.096598,"1505031",
"2915","4107603",Faxinal,15445,11248,72.826157,4197,-0.149863,"4107603",
"2916","3203346",Marechal Floriano,12642,6005,47.500396,6637,0.523835,"3203346",
"2917","2925907",Quijingue,27022,6205,22.962771,20817,0.346267,"2925907",
"2918","4320909",Tapejara,17463,15133,86.657504,2330,2.084233,"4320909",
"2919","3203353",Marilândia,10211,4826,47.262756,5385,0.408109,"3203353",
"2920","1505106",Óbidos,46462,23581,50.753304,22881,-0.008606,"1505106",
"2921","4321006",Tapera,10395,8638,83.097643,1757,-0.230122,"4321006",
"2922","3203403",Mimoso do Sul,25974,14695,56.575807,11279,-0.123141,"3203403",
"3151","2932507",Una,25101,14288,56.922035,10813,-3.086557,"2932507",
"2923","2925956",Rafael Jambeiro,23049,5927,25.714782,17122,0.281431,"2925956",
"2924","2406502",Lagoa Nova,13126,6107,46.525979,7019,1.21976,"2406502",
"2925","4321105",Tapes,16306,14480,88.801668,1826,0.013148,"4321105",
"2926","1505205",Oeiras do Pará,25327,10206,40.296916,15121,1.226762,"1505205",
"2927","2926004",Remanso,37783,21446,56.760977,16337,0.590692,"2926004",
"2928","3203502",Montanha,17579,13314,75.738097,4265,0.259472,"3203502",
"2929","2926103",Retirolândia,11922,6375,53.472572,5547,1.300508,"2926103",
"2930","2406700",Lajes,10344,8284,80.085073,2060,1.378028,"2406700",
"2931","4321303",Taquari,25562,21365,83.581097,4197,-0.180323,"4321303",
"2932","1505403",Ourém,14930,7367,49.343603,7563,0.520676,"1505403",
"2933","2926202",Riachão das Neves,22422,10632,47.417715,11790,0.325959,"2926202",
"2934","3203700",Muniz Freire,18171,7486,41.197513,10685,-1.139645,"3203700",
"2935","1505437",Ourilândia do Norte,20008,13523,67.587965,6485,0.389414,"1505437",
"2936","3203809",Muqui,13773,9068,65.83896,4705,0.107293,"3203809",
"2937","2926301",Riachão do Jacuípe,32429,16616,51.238089,15813,0.355662,"2926301",
"2938","1505486",Pacajá,38116,13857,36.354812,24259,4.03957,"1505486",
"2939","2926400",Riacho de Santana,29321,12239,41.741414,17082,0.334772,"2926400",
"2940","3203908",Nova Venécia,44077,29020,65.839327,15057,0.349025,"3203908",
"2941","4321402",Tenente Portela,13837,8505,61.465636,5332,-0.51177,"4321402",
"2942","4108007",Florestópolis,11548,10351,89.634569,1197,-0.76993,"4108007",
"2943","3204005",Pancas,18280,9256,50.634573,9024,-1.55669,"3204005",
"2944","2926509",Ribeira do Amparo,14075,1919,13.634103,12156,0.175805,"2926509",
"2945","3204054",Pedro Canário,23120,21343,92.314014,1777,0.737418,"3204054",
"2946","2926608",Ribeira do Pombal,47212,27864,59.018894,19348,0.288333,"2926608",
"2947","2407203",Macau,26890,20870,77.612495,6020,0.648716,"2407203",
"2948","4321451",Teutônia,25005,21193,84.755049,3812,1.269881,"4321451",
"2949","2926657",Ribeirão do Largo,14037,6076,43.285602,7961,-1.226025,"2926657",
"2950","3204104",Pinheiros,22613,18074,79.927475,4539,0.844681,"3204104",
"2951","2926707",Rio de Contas,13401,5970,44.548914,7431,-0.55665,"2926707",
"2952","3204203",Piúma,16134,15278,94.694434,856,1.059079,"3204203",
"2953","2926806",Rio do Antônio,15056,5602,37.207758,9454,0.404014,"2926806",
"2954","4321501",Torres,32098,28783,89.672254,3315,0.554173,"4321501",
"2955","1505635",Piçarra,12645,3376,26.6983,9269,-0.029339,"1505635",
"2956","2926905",Rio do Pires,11373,4745,41.721621,6628,-0.775513,"2926905",
"2957","3204302",Presidente Kennedy,10262,3528,34.379263,6734,1.024977,"3204302",
"2958","1505650",Placas,17527,3821,21.80065,13706,3.916695,"1505650",
"2959","4321600",Tramandaí,39603,38585,97.429488,1018,3.541677,"4321600",
"2960","3204351",Rio Bananal,16552,5506,33.264862,11046,0.198347,"3204351",
"2961","2927002",Rio Real,35970,22327,62.07117,13643,1.125281,"2927002",
"2962","4108502",General Carneiro,14107,9929,70.383498,4178,0.212429,"4108502",
"2963","1505700",Ponta de Pedras,24228,11146,46.004623,13082,3.773844,"1505700",
"2964","3204401",Rio Novo do Sul,11074,5916,53.422431,5158,-0.251584,"3204401",
"2965","2407708",Montanhas,12361,9452,76.466305,2909,0.486644,"2407708",
"2966","1505809",Portel,45247,22000,48.622008,23247,2.508361,"1505809",
"2967","2927200",Ruy Barbosa,29299,21046,71.831803,8253,0.133824,"2927200",
"2968","3204500",Santa Leopoldina,12314,2460,19.977262,9854,-0.171673,"3204500",
"2969","2407807",Monte Alegre,20524,8303,40.455077,12221,1.204476,"2407807",
"2970","4108601",Goioerê,28727,24808,86.357782,3919,-0.498634,"4108601",
"2971","1505908",Porto de Moz,25896,13201,50.976985,12695,1.368929,"1505908",
"2972","4321667",Três Cachoeiras,10365,6978,67.322721,3387,1.217709,"4321667",
"2973","3204559",Santa Maria de Jetibá,31767,10288,32.385809,21479,1.423694,"3204559",
"2974","2927309",Salinas da Margarida,13048,5713,43.784488,7335,3.326164,"2927309",
"2975","1506005",Prainha,26339,7648,29.03679,18691,-0.511155,"1506005",
"2976","4321709",Três Coroas,22783,20268,88.961067,2515,2.300292,"4321709",
"2977","3204609",Santa Teresa,20052,10224,50.987433,9828,-0.399622,"3204609",
"2978","4321808",Três de Maio,23251,18067,77.704185,5184,-0.532241,"4321808",
"2979","1506104",Primavera,10362,6645,64.128547,3717,0.920863,"1506104",
"2980","2927507",Santa Bárbara,19394,8003,41.26534,11391,1.125156,"2927507",
"2981","4108809",Guaíra,28529,25473,89.288093,3056,-0.064928,"4108809",
"2982","1506112",Quatipuru,11769,5802,49.299006,5967,1.095205,"1506112",
"2983","3204708",São Gabriel da Palha,28769,21449,74.555946,7320,1.13263,"3204708",
"2984","2927606",Santa Brígida,15453,4919,31.832007,10534,-1.273083,"2927606",
"2985","3204807",São José do Calçado,10537,7898,74.954921,2639,0.076154,"3204807",
"2986","2927705",Santa Cruz Cabrália,24362,17099,70.187177,7263,0.281084,"2927705",
"2987","2408300",Nova Cruz,35133,23859,67.910511,11274,0.53966,"2408300",
"2988","4321907",Três Passos,23182,17807,76.813907,5375,-0.876765,"4321907",
"2989","1506161",Rio Maria,16890,12874,76.222617,4016,-0.503938,"1506161",
"2990","1506187",Rondon do Pará,44595,32297,72.422917,12298,1.612833,"1506187",
"2991","3204955",São Roque do Canaã,10427,5071,48.633356,5356,0.043919,"3204955",
"2992","2927903",Santa Inês,10494,9447,90.02287,1047,-0.705261,"2927903",
"2993","1506195",Rurópolis,32821,12173,37.089059,20648,4.168632,"1506195",
"2994","4322004",Triunfo,23918,14603,61.054436,9315,1.092665,"4322004",
"2995","2928000",Santaluz,33309,20272,60.860428,13037,1.052545,"2928000",
"2996","1506203",Salinópolis,36729,32931,89.659397,3798,1.345323,"1506203",
"2997","3205010",Sooretama,21838,14845,67.977837,6993,2.581998,"3205010",
"2998","2928059",Santa Luzia,15007,8351,55.647365,6656,-0.463448,"2928059",
"2999","4109302",Guaraniaçu,15864,7904,49.8235,7960,-1.149275,"4109302",
"3000","1506302",Salvaterra,17029,11462,67.308709,5567,1.714993,"1506302",
"3001","2928109",Santa Maria da Vitória,40421,23074,57.084189,17347,-0.293401,"2928109",
"3002","3205036",Vargem Alta,17752,5402,30.430374,12350,0.3063,"3205036",
"3003","1506351",Santa Bárbara do Pará,13369,4167,31.169123,9202,2.33041,"1506351",
"3004","2928208",Santana,25889,13314,51.427247,12575,1.004863,"2928208",
"3005","3205069",Venda Nova do Imigrante,18598,12744,68.523497,5854,2.023131,"3205069",
"3006","2408904",Parelhas,19890,16502,82.966315,3388,0.416982,"2408904",
"3007","4322202",Tupanciretã,22369,17758,79.386651,4611,0.942711,"4322202",
"3008","4109609",Guaratuba,30703,27075,88.183565,3628,1.715259,"4109609",
"3009","1506500",Santa Isabel do Pará,49968,38404,76.857189,11564,2.091828,"1506500",
"3010","2928406",Santa Rita de Cássia,25963,13420,51.688942,12543,1.113813,"2928406",
"3011","2409100",Passa e Fica,10363,5991,57.811445,4372,3.170632,"2409100",
"3012","1506559",Santa Luzia do Pará,18038,8959,49.667369,9079,-1.034504,"1506559",
"3013","3205176",Vila Valério,13560,4850,35.766962,8710,-0.327525,"3205176",
"3014","1506583",Santa Maria das Barreiras,15732,4603,29.258835,11129,5.305991,"1506583",
"3015","4109708",Ibaiti,27851,21816,78.331119,6035,0.741138,"4109708",
"3016","2409308",Patu,11278,9067,80.39546,2211,0.136275,"2409308",
"3017","1506609",Santa Maria do Pará,22071,12012,54.424358,10059,0.816322,"1506609",
"3018","1506708",Santana do Araguaia,48511,28416,58.576405,20095,6.499576,"1506708",
"3019","2928802",Santo Estêvão,44334,23476,52.952587,20858,1.072127,"2928802",
"3020","2409407",Pau dos Ferros,26554,24018,90.44965,2536,1.005474,"2409407",
"3021","2928901",São Desidério,24984,8186,32.76497,16798,3.984192,"2928901",
"3022","1507003",Santo Antônio do Tauá,24773,13513,54.547289,11260,3.226771,"1507003",
"3023","3300225",Areal,10968,9542,86.998541,1426,1.475758,"3300225",
"3024","2929008",São Félix,15266,10080,66.029084,5186,1.55925,"2929008",
"3025","4110078",Imbaú,11160,6908,61.899642,4252,2.36737,"4110078",
"3026","1507102",São Caetano de Odivelas,16132,6673,41.364989,9459,0.484808,"1507102",
"3027","2929057",São Félix do Coribe,12745,9705,76.147509,3040,1.158158,"2929057",
"3028","3300233",Armação dos Búzios,24274,24274,100,0,4.196589,"3300233",
"3029","2409803",Pedro Velho,13604,6103,44.861805,7501,0.090637,"2409803",
"3030","4322533",Vale do Sol,10785,1122,10.403338,9663,0.304354,"4322533",
"3031","4110102",Imbituva,26888,16761,62.336358,10127,1.339901,"4110102",
"3032","1507151",São Domingos do Araguaia,21040,13712,65.171103,7328,0.723219,"1507151",
"3033","3300258",Arraial do Cabo,25183,25183,100,0,0.763666,"3300258",
"3034","2929107",São Felipe,20201,8931,44.210683,11270,-0.019079,"2929107",
"3035","2409902",Pendências,12470,9820,78.748998,2650,1.288584,"2409902",
"3036","4110201",Inácio Martins,10866,5942,54.684336,4924,-0.126881,"4110201",
"3037","1507201",São Domingos do Capim,26825,6082,22.67288,20743,-0.305122,"1507201",
"3038","2929255",São Gabriel,18399,10137,55.095386,8262,-0.01009,"2929255",
"3039","2410108",Poço Branco,12235,6951,56.812423,5284,-0.030321,"2410108",
"3040","1507409",São Francisco do Pará,11889,4604,38.724872,7285,-2.54968,"1507409",
"3041","2929305",São Gonçalo dos Campos,29143,14305,49.085544,14838,1.097087,"2929305",
"3042","4322707",Vera Cruz,22652,12134,53.567014,10518,0.883034,"4322707",
"3043","4110508",Ipiranga,13973,4721,33.786588,9252,0.699025,"4110508",
"3044","1507458",São Geraldo do Araguaia,24781,12895,52.035834,11886,-1.550762,"1507458",
"3045","3300506",Bom Jardim,24468,13768,56.269413,10700,1.108414,"3300506",
"3046","4110607",Iporã,15029,11498,76.505423,3531,-1.278046,"4110607",
"3047","4322806",Veranópolis,23353,20164,86.344367,3189,2.634917,"4322806",
"3048","3300605",Bom Jesus do Itabapoana,33312,27774,83.37536,5538,-0.146235,"3300605",
"3049","2929370",São José do Jacuípe,10475,6721,64.162291,3754,1.819315,"2929370",
"3050","1507474",São João de Pirabas,18595,10122,54.433988,8473,0.883978,"1507474",
"3051","2929404",São Miguel das Matas,10212,3209,31.423815,7003,0.271517,"2929404",
"3052","1507508",São João do Araguaia,11448,2510,21.925227,8938,-0.95917,"1507508",
"3053","4110805",Iretama,11040,5716,51.775362,5324,-0.376009,"4110805",
"3054","1507607",São Miguel do Guamá,42856,27106,63.24902,15750,0.506799,"1507607",
"3055","3300902",Cambuci,14338,10579,73.782954,3759,-0.326484,"3300902",
"3056","2929602",Sapeaçu,16466,8090,49.131544,8376,0.013889,"2929602",
"3057","1507706",São Sebastião da Boa Vista,20446,8681,42.458183,11765,2.111389,"1507706",
"3058","3300936",Carapebus,10578,8625,81.537153,1953,2.889076,"3300936",
"3059","2929701",Sátiro Dias,17937,3884,21.653565,14053,0.558633,"2929701",
"3060","2929750",Saubara,10957,10665,97.335037,292,1.037882,"2929750",
"3061","2929800",Saúde,11845,6452,54.470241,5393,0.43814,"2929800",
"3062","1507904",Soure,21331,19281,90.389574,2050,0.954979,"1507904",
"3063","3301108",Cantagalo,19643,13339,67.907142,6304,-0.138861,"3301108",
"3064","2929909",Seabra,40462,18585,45.931986,21877,0.372682,"2929909",
"3065","4111209",Itapejara d'Oeste,10481,6550,62.494037,3931,1.940001,"4111209",
"3066","2930006",Sebastião Laranjeiras,10666,4036,37.839865,6630,2.003759,"2930006",
"3067","3301157",Cardoso Moreira,12175,8581,70.480493,3594,-0.483332,"3301157",
"3068","3301207",Carmo,16405,12458,75.940262,3947,1.011547,"3301207",
"3069","1507979",Terra Santa,15303,10556,68.979939,4747,0.681964,"1507979",
"3070","2930154",Serra do Ramalho,30503,5263,17.254041,25240,-0.945321,"2930154",
"3071","3301306",Casimiro de Abreu,26976,23308,86.402728,3668,2.854552,"3301306",
"3072","2411205",Santa Cruz,33670,27992,83.136323,5678,1.050925,"2411205",
"3073","4111407",Ivaí,12639,4318,34.164095,8321,0.865624,"4111407",
"3074","1508001",Tomé-Açu,46489,28324,60.926241,18165,-0.238623,"1508001",
"3075","2930204",Sento Sé,36325,20961,57.704061,15364,1.619645,"2930204",
"3076","3301405",Conceição de Macabu,19288,16832,87.266694,2456,0.380496,"3301405",
"3077","2411403",Santana do Matos,14281,6575,46.040193,7706,-1.59916,"2411403",
"3078","4111506",Ivaiporã,31158,26212,84.126067,4946,-0.499704,"4111506",
"3079","1508035",Tracuateua,25694,6599,25.683039,19095,1.758135,"1508035",
"3080","2930303",Serra Dourada,17343,5762,33.223779,11581,-0.541611,"2930303",
"3081","3301504",Cordeiro,18967,18358,96.78916,609,0.278749,"3301504",
"3082","1508050",Trairão,15980,5871,36.739675,10109,1.864091,"1508050",
"3083","3301603",Duas Barras,10412,6779,65.107568,3633,0.10748,"3301603",
"3084","2930402",Serra Preta,15039,6275,41.724849,8764,-2.321007,"2930402",
"3085","2411502",Santo Antônio,21222,13325,62.788616,7897,0.773985,"2411502",
"3086","1508084",Tucumã,25978,20089,77.330818,5889,0.373409,"1508084",
"3087","4323804",Xangri-lá,10581,10514,99.36679,67,3.714344,"4323804",
"3088","4316402",Rosário do Sul,40282,35602,88.381908,4680,-0.272214,"4316402",
"3089","3301801",Engenheiro Paulo de Frontin,12420,9025,72.665056,3395,0.297976,"3301801",
"3090","2930600",Serrolândia,12100,6969,57.595041,5131,-0.594801,"2930600",
"3091","4111803",Jacarezinho,39108,34471,88.143091,4637,-0.187441,"4111803",
"3092","1508126",Ulianópolis,30039,22950,76.400679,7089,6.560176,"1508126",
"3093","1508159",Uruará,34749,18916,54.436099,15833,-3.687003,"1508159",
"3094","4111902",Jaguapitã,11625,9814,84.421505,1811,0.881919,"4111902",
"3095","2930758",Sítio do Mato,12413,6412,51.655522,6001,0.78479,"2930758",
"3096","3301876",Iguaba Grande,19683,19683,100,0,3.869997,"3301876",
"3097","5000203",Água Clara,13080,8931,68.279817,4149,2.485037,"5000203",
"3098","4112009",Jaguariaíva,31793,27572,86.723493,4221,0.463657,"4112009",
"3099","1508209",Vigia,43775,30034,68.609937,13741,1.233157,"1508209",
"3100","2930766",Sítio do Quinto,13748,4578,33.299389,9170,-3.01285,"2930766",
"3101","4112108",Jandaia do Sul,19394,17328,89.347221,2066,-0.206014,"4112108",
"3102","2930774",Sobradinho,21139,19051,90.122522,2088,-0.125071,"2930774",
"3103","5000609",Amambaí,32990,19515,59.154289,13475,1.618047,"5000609",
"3104","2930808",Souto Soares,17974,6144,34.182708,11830,2.819546,"2930808",
"3105","3302056",Italva,13583,9871,72.671722,3712,1.05491,"3302056",
"3106","5000708",Anastácio,22242,18017,81.004406,4225,-0.150033,"5000708",
"3107","1508407",Xinguara,37994,29389,77.351687,8605,1.088946,"1508407",
"3108","2930907",Tabocas do Brejo Velho,12244,3702,30.235217,8542,-0.430038,"2930907",
"3109","3302106",Itaocara,21973,15956,72.616393,6017,-0.652295,"3302106",
"3110","2412302",São José do Campestre,11730,9623,82.037511,2107,-0.303195,"2412302",
"3111","1507805",Senador José Porfírio,14123,6185,43.793812,7938,-1.519659,"1507805",
"3112","2931004",Tanhaçu,19575,7954,40.633461,11621,-0.337666,"2931004",
"3113","4112504",Jardim Alegre,14292,7604,53.20459,6688,0.634531,"4112504",
"3114","3302254",Itatiaia,30959,29144,94.137408,1815,3.255922,"3302254",
"3115","2931053",Tanque Novo,15710,6348,40.407384,9362,-0.055347,"2931053",
"3116","2412500",São Miguel,22510,13156,58.445135,9354,1.613544,"2412500",
"3117","5001003",Aparecida do Taboado,19692,17376,88.238879,2316,0.972601,"5001003",
"3118","4112702",Jataizinho,11154,10434,93.544917,720,-0.219631,"4112702",
"3119","2931202",Taperoá,18056,8293,45.929331,9763,1.802999,"2931202",
"3120","2412609",São Paulo do Potengi,14411,11067,76.795503,3344,0.597927,"2412609",
"3121","5001102",Aquidauana,44408,34950,78.702036,9458,0.315338,"5001102",
"3122","2931301",Tapiramutá,17201,12522,72.798093,4679,0.116816,"2931301",
"3123","4112801",Joaquim Távora,10172,7639,75.098309,2533,0.739027,"4112801",
"3124","2931509",Teofilândia,20651,6086,29.470728,14565,0.152422,"2931509",
"3125","2412906",São Tomé,11055,6040,54.635911,5015,0.336592,"2412906",
"3126","5001904",Bataguassu,18482,13731,74.293908,4751,1.903188,"5001904",
"3127","2931608",Teolândia,12313,4120,33.46057,8193,-0.296937,"2931608",
"3128","5002001",Batayporã,10411,7474,71.789453,2937,-0.290246,"5002001",
"3129","2931707",Terra Nova,12280,10837,88.249186,1443,-0.673657,"2931707",
"3130","5002100",Bela Vista,22310,18000,80.681309,4310,0.354595,"5002100",
"3131","3302809",Mendes,17235,17087,99.141282,148,-0.044679,"3302809",
"3132","2931806",Tremedal,18475,3890,21.05548,14585,-1.946278,"2931806",
"3133","4113205",Lapa,41510,24731,59.578415,16779,-0.112375,"4113205",
"3134","3302908",Miguel Pereira,24543,21273,86.676445,3270,0.37878,"3302908",
"3135","2931905",Tucano,48588,19676,40.495596,28912,-0.675266,"2931905",
"3136","5002209",Bonito,17073,13446,78.75593,3627,0.098284,"5002209",
"3137","3303005",Miracema,26131,24216,92.67154,1915,-0.499919,"3303005",
"3138","2932002",Uauá,24591,10053,40.88081,14538,-0.788968,"2932002",
"3139","5002308",Brasilândia,12051,7729,64.135756,4322,0.113127,"5002308",
"3140","4113304",Laranjeiras do Sul,30039,23926,79.649789,6113,0.00666,"4113304",
"3141","3303104",Natividade,14846,11808,79.536576,3038,-0.265626,"3303104",
"3142","2932101",Ubaíra,20590,8463,41.102477,12127,-0.003469,"2932101",
"3143","5002407",Caarapó,22565,15838,70.188345,6727,1.23581,"5002407",
"3144","2932200",Ubaitaba,20345,17859,87.780782,2486,-2.247456,"2932200",
"3145","5002605",Camapuã,13111,9578,73.053161,3533,-3.185733,"5002605",
"3146","2932309",Ubatã,24756,17449,70.483923,7307,1.831139,"2932309",
"3147","2932408",Uibaí,13682,8042,58.777956,5640,0.071203,"2932408",
"3148","4113502",Loanda,19304,17178,88.986738,2126,-0.180006,"4113502",
"3149","2932457",Umburanas,16045,7397,46.101589,8648,1.821965,"2932457",
"3150","5002902",Cassilândia,20663,18608,90.054687,2055,0.4047,"5002902",
"3152","5002951",Chapadão do Sul,16116,13131,81.478034,2985,4.734667,"5002951",
"3153","3303708",Paraíba do Sul,39053,33962,86.96387,5091,0.615913,"3303708",
"3154","2932606",Urandi,15805,5462,34.558684,10343,-0.242579,"2932606",
"3155","2413904",Taipu,11707,4118,35.175536,7589,0.216633,"2413904",
"3156","3303807",Parati,32523,14786,45.463211,17737,1.381844,"3303807",
"3157","2932705",Uruçuca,21916,17500,79.850338,4416,1.083885,"2932705",
"3158","2414001",Tangará,12991,8776,67.554461,4215,0.998738,"2414001",
"3159","5003157",Coronel Sapucaia,13860,10201,73.600289,3659,1.131798,"5003157",
"3160","3303856",Paty do Alferes,24985,17613,70.494297,7372,0.030914,"3303856",
"3161","2932804",Utinga,19125,12982,67.879739,6143,1.792066,"2932804",
"3162","1600279",Laranjal do Jari,37392,35488,94.908002,1904,3.947739,"1600279",
"3163","5003256",Costa Rica,18090,14636,80.906578,3454,2.243274,"5003256",
"3164","4113908",Mallet,12352,7109,57.553433,5243,-0.285841,"4113908",
"3165","2933000",Valente,21469,11484,53.49108,9985,1.650159,"2933000",
"3166","2414209",Tibau do Sul,10793,6867,63.624571,3926,4.847154,"2414209",
"3167","5003306",Coxim,31712,28427,89.641145,3285,0.387031,"5003306",
"3168","4114005",Mamborê,14058,8933,63.54389,5125,-1.068605,"4114005",
"3169","2933059",Várzea da Roça,14401,6311,43.823346,8090,0.785992,"2933059",
"3170","5003454",Deodápolis,11212,9013,80.387085,2199,-0.174606,"5003454",
"3171","1600402",Mazagão,13694,7328,53.512487,6366,1.921346,"1600402",
"3172","4114104",Mandaguaçu,18236,15752,86.378592,2484,1.154521,"4114104",
"3173","3304102",Porciúncula,17084,12955,75.831187,4129,0.984214,"3304102",
"3174","2414407",Touros,29147,7821,26.83295,21326,0.637427,"2414407",
"3175","1600501",Oiapoque,18858,12314,65.298547,6544,5.590624,"1600501",
"3176","3304110",Porto Real,14502,14422,99.448352,80,2.626682,"3304110",
"3177","2933158",Várzea Nova,13905,8836,63.545487,5069,-0.253233,"2933158",
"3178","1600535",Porto Grande,13781,9091,65.967637,4690,3.21613,"1600535",
"3179","4114302",Mandirituba,20209,6788,33.588995,13421,2.044098,"4114302",
"3180","3304128",Quatis,11999,10812,90.107509,1187,1.609672,"3304128",
"3181","2414506",Umarizal,10640,8553,80.385338,2087,-0.592575,"2414506",
"3182","2933208",Vera Cruz,34723,32704,94.18541,2019,2.232749,"2933208",
"3183","2414605",Upanema,12710,5902,46.435877,6808,2.097587,"2414605",
"3184","5003751",Eldorado,11862,8800,74.186478,3062,1.006394,"5003751",
"3185","4114401",Mangueirinha,16961,7167,42.255763,9794,-0.655445,"4114401",
"3186","3304151",Quissamã,17283,10072,58.27692,7211,3.402714,"3304151",
"3187","5003801",Fátima do Sul,18732,16449,87.8123,2283,-0.285745,"5003801",
"3188","4114500",Manoel Ribas,12689,6347,50.019702,6342,-0.417383,"4114500",
"3189","1600709",Tartarugalzinho,12256,5999,48.947454,6257,8.065439,"1600709",
"3190","4114609",Marechal Cândido Rondon,44382,35300,79.536749,9082,1.136281,"4114609",
"3191","1600808",Vitória do Jari,10590,9304,87.856468,1286,3.086827,"1600808",
"3192","2414803",Vera Cruz,10309,5020,48.695315,5289,2.756834,"2414803",
"3193","5004106",Guia Lopes da Laguna,10164,8379,82.438017,1785,-1.269635,"5004106",
"3194","3304409",Rio Claro,17146,15010,87.542284,2136,0.789194,"3304409",
"3195","2933455",Wanderley,12892,5954,46.18368,6938,-0.81182,"2933455",
"3196","5004304",Iguatemi,14488,10221,70.54804,4267,0.889673,"5004304",
"3197","2933505",Wenceslau Guimarães,23609,7011,29.696302,16598,-0.190358,"2933505",
"3198","2933604",Xique-Xique,45518,31687,69.614219,13831,0.253632,"2933604",
"3199","5004502",Itaporã,18542,12258,66.109373,6284,1.209853,"5004502",
"3200","2908507",Conceição do Jacuípe,27442,20824,75.883682,6618,0.667134,"2908507",
"3201","5004601",Itaquiraí,16745,7054,42.126008,9691,0.860687,"5004601",
"3202","4115101",Mariluz,10433,8511,81.577686,1922,0.189013,"4115101",
"3203","3304607",Santa Maria Madalena,10369,5751,55.463401,4618,-0.146555,"3304607",
"3204","2500304",Alagoa Grande,27394,16365,59.739359,11029,-0.892883,"2500304",
"3205","5004700",Ivinhema,20402,15365,75.311244,5037,-0.840011,"5004700",
"3206","3100203",Abaeté,22290,19327,86.707044,2963,-0.044783,"3100203",
"3207","3304706",Santo Antônio de Pádua,39963,30149,75.442284,9814,0.462799,"3304706",
"3208","2500403",Alagoa Nova,19160,9218,48.110647,9942,0.443957,"2500403",
"3209","3100302",Abre Campo,12773,6563,51.381821,6210,-0.627068,"3100302",
"3210","3304755",São Francisco de Itabapoana,44148,22178,50.235571,21970,1.011441,"3304755",
"3211","2500502",Alagoinha,12911,8185,63.395554,4726,1.253324,"2500502",
"3212","3304805",São Fidélis,37368,28512,76.300578,8856,0.223332,"3304805",
"3213","5005004",Jardim,23168,21334,92.083909,1834,0.392078,"5005004",
"3214","4115408",Marmeleiro,13124,7722,58.838769,5402,-0.575412,"4115408",
"3215","3100500",Açucena,10902,4462,40.92827,6440,-0.746398,"3100500",
"3216","3100609",Água Boa,16358,6932,42.376819,9426,-1.195658,"3100609",
"3217","3305000",São João da Barra,28809,21601,74.980041,7208,0.571706,"3305000",
"3218","2500601",Alhandra,17996,10799,60.00778,7197,1.771949,"2500601",
"3219","2500700",São João do Rio do Peixe,17732,6623,37.350553,11109,0.057332,"2500700",
"3220","5005202",Ladário,17753,16671,93.905255,1082,2.134641,"5005202",
"3221","4115606",Matelândia,14666,10946,74.635211,3720,0.317648,"4115606",
"3222","4115705",Matinhos,23176,23035,99.391612,141,-0.606354,"4115705",
"3223","3305158",São José do Vale do Rio Preto,19340,8365,43.252327,10975,0.045881,"3305158",
"3224","3100906",Águas Formosas,18402,13967,75.899359,4435,0.440051,"3100906",
"3225","5005400",Maracaju,30721,25919,84.368998,4802,2.289562,"5005400",
"3226","1702208",Araguatins,25518,16993,66.592209,8525,-0.272442,"1702208",
"3227","3101003",Águas Vermelhas,12630,8808,69.738717,3822,0.880813,"3101003",
"3228","2500809",Araçagi,17340,6358,36.666667,10982,-0.607003,"2500809",
"3229","5005608",Miranda,23758,14347,60.38808,9411,0.459923,"5005608",
"3230","3101102",Aimorés,24104,18930,78.534683,5174,-0.579589,"3101102",
"3231","2500908",Arara,12349,8296,67.179529,4053,0.985146,"2500908",
"3232","5005681",Mundo Novo,15683,13873,88.458841,1810,0.012759,"5005681",
"3233","4115804",Medianeira,38183,33938,88.882487,4245,0.133908,"4115804",
"3234","1702406",Arraias,10509,6918,65.829289,3591,-0.629548,"1702406",
"3235","3305406",Sapucaia,16806,12433,73.979531,4373,-0.294854,"3305406",
"3236","2501005",Araruna,19136,8916,46.592809,10220,2.047355,"2501005",
"3237","5005707",Naviraí,42981,39670,92.296596,3311,2.297676,"5005707",
"3238","1702554",Augustinópolis,14671,12122,82.625588,2549,1.782798,"1702554",
"3239","2501104",Areia,24892,13960,56.082275,10932,-0.691539,"2501104",
"3240","5005806",Nioaque,14986,6959,46.436674,8027,-0.094965,"5005806",
"3241","5006002",Nova Alvorada do Sul,11856,7977,67.282389,3879,2.526513,"5006002",
"3242","3101508",Além Paraíba,33356,30728,92.121357,2628,-0.108312,"3101508",
"3243","3305604",Silva Jardim,21301,16092,75.545749,5209,0.024167,"3305604",
"3244","4116059",Missal,10293,5300,51.491305,4993,-0.192811,"4116059",
"3245","5006200",Nova Andradina,43239,36317,83.991304,6922,2.906699,"5006200",
"3246","1703008",Babaçulândia,10298,5299,51.456594,4999,-0.04293,"1703008",
"3247","3305703",Sumidouro,14502,2359,16.266722,12143,0.325331,"3305703",
"3248","2501302",Aroeiras,18997,8436,44.407012,10561,-0.387227,"2501302",
"3249","4116109",Moreira Sales,12865,9649,75.001943,3216,-0.575069,"4116109",
"3250","3305752",Tanguá,28148,25049,88.990337,3099,1.108815,"3305752",
"3251","5006309",Paranaíba,38211,33495,87.658004,4716,-0.072692,"5006309",
"3252","4116208",Morretes,16113,7523,46.689009,8590,0.765902,"4116208",
"3253","3101706",Almenara,36571,29784,81.441579,6787,0.472076,"3101706",
"3254","5006358",Paranhos,11017,5402,49.033312,5615,1.085598,"5006358",
"3255","2501500",Bananeiras,21601,8445,39.095412,13156,-0.137462,"2501500",
"3256","3101904",Alpinópolis,17728,14231,80.274143,3497,0.574646,"3101904",
"3257","3102001",Alterosa,13243,9788,73.910745,3455,0.29139,"3102001",
"3258","5006903",Porto Murtinho,14113,8982,63.643449,5131,0.833887,"5006903",
"3259","2501609",Barra de Santa Rosa,12803,7060,55.143326,5743,-0.356387,"2501609",
"3260","5007109",Ribas do Rio Pardo,18957,12784,67.436831,6173,1.809139,"5007109",
"3261","4116703",Nova Aurora,11718,8703,74.270353,3015,-2.147378,"4116703",
"3262","3306206",Vassouras,32263,21072,65.313207,11191,0.364811,"3306206",
"3263","3102100",Alto Rio Doce,12581,4754,37.787139,7827,-1.371578,"3102100",
"3264","5007208",Rio Brilhante,26208,20192,77.045177,6016,2.112671,"5007208",
"3265","4116901",Nova Esperança,25627,22599,88.184337,3028,-0.056731,"4116901",
"3266","3102308",Alvinópolis,15150,10980,72.475248,4170,-0.406327,"3102308",
"3267","2501906",Belém,17124,13906,81.207662,3218,0.440641,"2501906",
"3268","5007406",Rio Verde de Mato Grosso,18487,15756,85.227457,2731,0.272637,"5007406",
"3269","4117057",Nova Laranjeiras,11229,2020,17.989135,9209,-0.584054,"4117057",
"3270","3102605",Andradas,34753,26278,75.613616,8475,0.756109,"3102605",
"3271","5007695",São Gabriel do Oeste,20339,17532,86.198928,2807,2.750168,"5007695",
"3272","4117107",Nova Londrina,12513,10910,87.189323,1603,-0.727306,"4117107",
"3273","5007703",Sete Quedas,10523,8679,82.47648,1844,-0.548444,"5007703",
"3274","3102803",Andrelândia,11904,9344,78.494624,2560,-0.477961,"3102803",
"3275","5007901",Sidrolândia,36915,22732,61.579304,14183,6.675377,"5007901",
"3276","3102902",Antônio Carlos,11149,6803,61.018925,4346,0.362701,"3102902",
"3277","2502409",Bonito de Santa Fé,10188,6572,64.507263,3616,1.420734,"2502409",
"3278","5007935",Sonora,12388,10775,86.979335,1613,3.797774,"5007935",
"3279","4117255",Nova Prata do Iguaçu,10307,5843,56.689628,4464,-0.124123,"4117255",
"3280","2502508",Boqueirão,15836,11318,71.470068,4518,-0.027934,"2502508",
"3281","1705508",Colinas do Tocantins,29180,28133,96.411926,1047,2.058612,"1705508",
"3282","5008008",Terenos,12398,6081,49.048234,6317,0.878111,"5008008",
"3283","4117305",Ortigueira,24210,8665,35.790995,15545,-0.579925,"4117305",
"3284","2502805",Brejo do Cruz,12401,9180,74.026288,3221,0.629565,"2502805",
"3285","3103405",Araçuaí,35807,22140,61.831485,13667,0.037559,"3103405",
"3286","2503001",Caaporã,19288,15373,79.702406,3915,0.643586,"2503001",
"3287","5100201",Água Boa,18621,14978,80.436067,3643,1.5355,"5100201",
"3288","4117602",Palmas,40101,36281,90.474053,3820,2.038179,"4117602",
"3289","5100250",Alta Floresta,48747,41432,84.993948,7315,0.528235,"5100250",
"3290","4117701",Palmeira,31013,18341,59.139716,12672,0.0767,"4117701",
"3291","1707009",Dianópolis,17283,14600,84.476075,2683,1.635216,"1707009",
"3292","5100300",Alto Araguaia,13503,11442,84.736725,2061,2.435203,"5100300",
"3293","4117800",Palmital,15347,7167,46.699681,8180,-1.415876,"4117800",
"3294","4117909",Palotina,27404,22965,83.801635,4439,0.881565,"4117909",
"3295","2503506",Cacimba de Dentro,17046,8553,50.175994,8493,0.193405,"2503506",
"3296","4118006",Paraíso do Norte,11109,9416,84.760104,1693,1.898033,"4118006",
"3297","3104205",Arcos,34726,31774,91.499165,2952,0.868193,"3104205",
"3298","3104304",Areado,13089,10856,82.939873,2233,0.976794,"3104304",
"3299","1708205",Formoso do Araguaia,18122,12991,71.686348,5131,-0.536187,"1708205",
"3300","5101258",Araputanga,15108,12055,79.792163,3053,1.433826,"5101258",
"3301","3104502",Arinos,17274,10703,61.960171,6571,-0.354662,"3104502",
"3302","3104601",Astolfo Dutra,12474,11225,89.987173,1249,0.790585,"3104601",
"3303","5101407",Aripuanã,18936,11454,60.487959,7482,-5.220246,"5101407",
"3304","1709005",Goiatins,11627,5010,43.089361,6617,0.748031,"1709005",
"3305","3104700",Ataléia,15055,7118,47.279973,7937,-1.51004,"3104700",
"3306","4118808",Peabiru,12939,10699,82.687998,2240,-0.590823,"4118808",
"3307","1709302",Guaraí,21621,19567,90.499977,2054,1.106552,"1709302",
"3308","5101704",Barra do Bugres,31710,25900,81.677704,5810,2.077014,"5101704",
"3309","3104908",Baependi,17848,12602,70.607351,5246,0.262876,"3104908",
"3310","5101902",Brasnorte,13861,7879,56.842941,5982,5.054557,"5101902",
"3311","3105103",Bambuí,21498,17932,83.41241,3566,-0.131543,"3105103",
"3312","2504306",Catolé do Rocha,27417,19774,72.123135,7643,0.411012,"2504306",
"3313","4119103",Piên,11053,3470,31.394192,7583,1.736674,"4119103",
"3314","5102603",Campinápolis,13590,5310,39.072848,8280,1.295559,"5102603",
"3315","2504405",Conceição,17410,10406,59.770247,7004,-0.420347,"2504405",
"3316","5102637",Campo Novo do Parecis,20968,18655,88.968905,2313,2.501369,"5102637",
"3317","3105400",Barão de Cocais,26202,23789,90.790779,2413,1.634419,"3105400",
"3318","5102678",Campo Verde,25747,20112,78.113955,5635,5.913814,"5102678",
"3319","2504603",Conde,19741,12655,64.105162,7086,2.672575,"2504603",
"3320","4119301",Pinhão,28921,14220,49.168424,14701,0.256001,"4119301",
"3321","4119400",Piraí do Sul,23054,15988,69.350221,7066,0.903665,"4119400",
"3322","2504801",Coremas,15112,11116,73.557438,3996,-0.017004,"2504801",
"3323","5102702",Canarana,17040,13601,79.818075,3439,1.44863,"5102702",
"3324","3105905",Barroso,19201,18650,97.130358,551,0.642663,"3105905",
"3325","5102793",Carlinda,12096,4831,39.938823,7265,-0.234,"5102793",
"3326","4119608",Pitanga,34043,18802,55.23015,15241,-0.740472,"4119608",
"3327","5103007",Chapada dos Guimarães,17236,9818,56.962172,7418,1.291735,"5103007",
"3328","2505105",Cuité,20152,12936,64.19214,7216,0.146892,"2505105",
"3329","5103056",Cláudia,10389,8092,77.890076,2297,0.194008,"5103056",
"3330","4119806",Planalto,13585,5228,38.483622,8357,-0.552292,"4119806",
"3331","3106309",Belo Oriente,21236,17783,83.739876,3453,1.213926,"3106309",
"3332","5103205",Colíder,30407,24314,79.961851,6093,1.158785,"5103205",
"3333","4119954",Pontal do Paraná,16540,16370,98.972189,170,2.077209,"4119954",
"3334","3106507",Berilo,13123,3618,27.569915,9505,0.157749,"3106507",
"3335","5103304",Comodoro,17647,11222,63.591545,6425,2.304051,"5103304",
"3336","4120002",Porecatu,14105,11220,79.54626,2885,-1.67993,"4120002",
"3337","5103353",Confresa,21134,9353,44.255702,11781,2.449285,"5103353",
"3338","1713205",Miracema do Tocantins,19608,16651,84.919421,2957,-3.100173,"1713205",
"3339","5103379",Cotriguaçu,13620,5490,40.30837,8130,7.014157,"5103379",
"3340","1713304",Miranorte,11813,10505,88.927453,1308,0.01331,"1713304",
"3341","3106903",Bicas,13584,12583,92.631037,1001,0.860747,"3106903",
"3342","5103502",Diamantino,18188,13470,74.05982,4718,-0.304161,"5103502",
"3343","2505709",Dona Inês,10811,4442,41.087781,6369,0.796482,"2505709",
"3344","3107109",Boa Esperança,37596,31055,82.601873,6541,0.199939,"3107109",
"3345","5103700",Feliz Natal,10199,7500,73.536621,2699,6.031107,"5103700",
"3346","4120507",Primeiro de Maio,10702,9719,90.814801,983,-0.034658,"4120507",
"3347","3107307",Bocaiúva,44356,34758,78.361439,9598,0.509432,"3107307",
"3348","2506004",Esperança,29699,20400,68.689181,9299,0.759985,"2506004",
"3349","4120606",Prudentópolis,48193,21345,44.290665,26848,0.55983,"4120606",
"3350","1714880",Nova Olinda,10477,7261,69.30419,3216,1.584852,"1714880",
"3351","3107406",Bom Despacho,42062,39299,93.431125,2763,0.74118,"3107406",
"3352","2506103",Fagundes,11817,5335,45.146822,6482,-0.090341,"2506103",
"3353","5104104",Guarantã do Norte,30556,21886,71.625867,8670,1.152868,"5104104",
"3354","5104203",Guiratinga,13710,11385,83.041575,2325,1.161893,"5104203",
"3355","3107802",Bom Jesus do Galho,15108,9576,63.383638,5532,-0.968406,"3107802",
"3356","2506400",Gurinhém,13146,5659,43.047315,7487,-0.03906,"2506400",
"3357","4120903",Quedas do Iguaçu,29726,19847,66.766467,9879,1.189791,"4120903",
"3358","3107901",Bom Repouso,10452,5528,52.889399,4924,-0.084455,"3107901",
"3359","4121000",Querência do Norte,11764,7145,60.736144,4619,0.402277,"4121000",
"3360","3108008",Bom Sucesso,17094,13929,81.484731,3165,0.025097,"3108008",
"3361","5104609",Itiquira,11759,3819,32.477251,7940,3.568117,"5104609",
"3362","2506707",Imaculada,11437,4975,43.499169,6462,-0.173658,"2506707",
"3363","5104807",Jaciara,24589,22798,92.716255,1791,0.469408,"5104807",
"3364","4121208",Quitandinha,15860,3329,20.989912,12531,0.541161,"4121208",
"3365","1716109",Paraíso do Tocantins,40085,38159,95.19521,1926,1.495046,"1716109",
"3366","2506806",Ingá,18109,11214,61.92501,6895,0.512053,"2506806",
"3367","1716208",Paranã,10478,4252,40.580263,6226,0.084818,"1716208",
"3368","2506905",Itabaiana,24656,19896,80.694354,4760,-0.315237,"2506905",
"3369","5105002",Jauru,10686,6493,60.761744,4193,-2.50654,"5105002",
"3370","3108305",Borda da Mata,14847,12076,81.336297,2771,0.398864,"3108305",
"3371","2507002",Itaporanga,22369,16272,72.743529,6097,0.822126,"2507002",
"3372","5105101",Juara,31670,26000,82.096621,5670,0.422962,"5105101",
"3373","1716505",Pedro Afonso,10128,8715,86.048578,1413,1.656034,"1716505",
"3374","3108404",Botelhos,14752,10701,72.539317,4051,-0.333476,"3108404",
"3375","2507101",Itapororoca,15952,9941,62.318205,6011,1.24056,"2507101",
"3376","5105150",Juína,38197,32624,85.409849,5573,0.067502,"5105150",
"3377","4121406",Realeza,15756,10562,67.03478,5194,-0.239768,"4121406",
"3378","4121505",Rebouças,13978,7266,51.981686,6712,0.326148,"4121505",
"3379","3108552",Brasilândia de Minas,12755,10868,85.205802,1887,1.524749,"3108552",
"3380","2507309",Jacaraú,13642,7365,53.987685,6277,-0.487756,"2507309",
"3381","5105200",Juscimeira,11822,8696,73.557774,3126,-0.287881,"5105200",
"3382","3108602",Brasília de Minas,30993,18684,60.28458,12309,0.339667,"3108602",
"3383","4121703",Reserva,24184,10749,44.446742,13435,0.122879,"4121703",
"3384","5105259",Lucas do Rio Verde,29955,27458,91.664163,2497,6.468646,"5105259",
"3385","4121802",Ribeirão Claro,10800,7040,65.185185,3760,-0.135506,"4121802",
"3386","3108909",Brasópolis,14330,7637,53.293789,6693,-0.805806,"3108909",
"3387","2507705",Juazeirinho,15847,8127,51.284155,7720,0.9103,"2507705",
"3388","5105507",Vila Bela da Santíssima Trindade,13652,4769,34.932611,8883,1.077821,"5105507",
"3389","4121901",Ribeirão do Pinhal,13307,10829,81.378222,2478,-1.06334,"4121901",
"3390","5105580",Marcelândia,13817,8941,64.71014,4876,-0.635916,"5105580",
"3391","4122008",Rio Azul,13146,4248,32.314012,8898,0.134383,"4122008",
"3392","3109105",Bueno Brandão,10800,5432,50.296296,5368,-0.173394,"3109105",
"3393","2507903",Juripiranga,10204,9417,92.287338,787,0.805121,"2507903",
"3394","5105606",Matupá,14150,10327,72.982332,3823,3.279571,"5105606",
"3395","2508000",Juru,10217,4232,41.421161,5985,0.242837,"2508000",
"3396","5105622",Mirassol d'Oeste,24308,20278,83.421096,4030,0.79517,"5105622",
"3397","4122156",Rio Bonito do Iguaçu,13953,2982,21.371748,10971,0.166973,"4122156",
"3398","1718204",Porto Nacional,44938,38789,86.316703,6149,-0.016837,"1718204",
"3399","5105903",Nobres,14809,11824,79.843339,2985,-0.166734,"5105903",
"3400","3109303",Buritis,21022,14866,70.716392,6156,0.432801,"3109303",
"3401","3500105",Adamantina,33010,31080,94.153287,1930,-0.209,"3500105",
"3402","3109402",Buritizeiro,26053,22721,87.210686,3332,0.08197,"3109402",
"3403","5106109",Nossa Senhora do Livramento,12264,4174,34.034573,8090,0.144104,"5106109",
"3404","4122305",Rio Negro,29710,23112,77.791989,6598,0.490315,"4122305",
"3405","5106158",Nova Bandeirantes,12559,4320,34.397643,8239,8.818093,"5106158",
"3406","3500303",Aguaí,29968,27159,90.626668,2809,0.875027,"3500303",
"3407","3109501",Cabo Verde,13522,7282,53.85298,6240,-0.214722,"3109501",
"3408","4122503",Roncador,12188,7102,58.27043,5086,-1.58682,"4122503",
"3409","3500501",Águas de Lindóia,15616,15502,99.26998,114,-0.514355,"3500501",
"3410","3109709",Cachoeira de Minas,10766,6589,61.201932,4177,0.283162,"3109709",
"3411","2508604",Lucena,10062,8266,82.150666,1796,0.443638,"2508604",
"3412","5106216",Nova Canaã do Norte,11981,6699,55.91353,5282,0.567098,"5106216",
"3413","5106224",Nova Mutum,24041,17398,72.368038,6643,7.157674,"5106224",
"3414","5106232",Nova Olímpia,18913,17369,91.836303,1544,4.194051,"5106232",
"3415","3500709",Agudos,33799,32481,96.100476,1318,0.568518,"3500709",
"3416","2508901",Mamanguape,40093,32617,81.353353,7476,0.479767,"2508901",
"3417","2509008",Manaíra,10976,5815,52.979227,5161,0.672401,"2509008",
"3418","4123006",Salto do Lontra,12372,5997,48.472357,6375,-0.436819,"4123006",
"3419","5106257",Nova Xavantina,18576,14671,78.978252,3905,0.585649,"5106257",
"3420","3110301",Caldas,13802,7785,56.404869,6017,1.120923,"3110301",
"3421","2509107",Mari,20513,17098,83.352021,3415,-0.104029,"2509107",
"3422","3501004",Altinópolis,15072,13240,87.845011,1832,-0.381766,"3501004",
"3423","3110509",Camanducaia,19378,14086,72.69068,5292,-0.82642,"3110509",
"3424","2509206",Massaranduba,12480,4232,33.910256,8248,0.92994,"2509206",
"3425","5106299",Paranaíta,11498,6336,55.105236,5162,1.649241,"5106299",
"3426","3110608",Cambuí,24879,19933,80.11978,4946,1.147658,"3110608",
"3427","5106307",Paranatinga,19844,14578,73.463011,5266,3.744216,"5106307",
"3428","4123501",Santa Helena,22364,10296,46.038276,12068,1.257364,"4123501",
"3429","3110707",Cambuquira,12394,10087,81.386155,2307,-0.164886,"3110707",
"3430","5106372",Pedra Preta,15536,11096,71.421215,4440,1.907706,"5106372",
"3431","3501301",Álvares Machado,22811,20646,90.508965,2165,0.094294,"3501301",
"3432","5106422",Peixoto de Azevedo,28720,19690,68.558496,9030,1.344894,"5106422",
"3433","3110905",Campanha,15044,12887,85.662058,2157,0.932122,"3110905",
"3434","4123808",Santa Izabel do Oeste,11368,6311,55.515482,5057,-0.423759,"4123808",
"3435","1720200",São Miguel do Tocantins,10206,2360,23.123653,7846,2.671608,"1720200",
"3436","3111002",Campestre,20108,10801,53.714939,9307,-0.312214,"3111002",
"3437","2509404",Mogeiro,12294,5279,42.939645,7015,-1.043817,"2509404",
"3438","5106505",Poconé,30673,22200,72.376357,8473,-0.046488,"5106505",
"3439","3111101",Campina Verde,18027,13253,73.517502,4774,-0.822565,"3111101",
"3440","4123857",Santa Maria do Oeste,11506,2864,24.891361,8642,-2.400221,"4123857",
"3441","3501707",Américo Brasiliense,30952,30509,98.568752,443,1.294526,"3501707",
"3442","4123907",Santa Mariana,11960,7949,66.463211,4011,-1.684188,"4123907",
"3443","2509701",Monteiro,29775,18665,62.686818,11110,1.044072,"2509701",
"3444","5106752",Pontes e Lacerda,37739,31286,82.900978,6453,-1.851013,"5106752",
"3445","3111309",Campo do Meio,11408,10080,88.359046,1328,-0.035014,"3111309",
"3446","2509909",Natuba,10210,3059,29.960823,7151,-0.483044,"2509909",
"3447","3111507",Campos Altos,13122,12339,94.032922,783,0.334297,"3111507",
"3448","4124053",Santa Terezinha de Itaipu,19488,17048,87.479475,2440,0.84914,"4124053",
"3449","3502200",Angatuba,21458,15231,70.98052,6227,1.527954,"3502200",
"3450","1720903",Taguatinga,14032,9656,68.814139,4376,0.910907,"1720903",
"3451","3111606",Campos Gerais,26819,18751,69.91685,8068,0.148966,"3111606",
"3452","4124103",Santo Antônio da Platina,40262,34005,84.459292,6257,0.113703,"4124103",
"3453","5107008",Poxoréo,17204,12098,70.320856,5106,-2.14927,"5107008",
"3454","3111804",Canápolis,11182,9903,88.561975,1279,0.721778,"3111804",
"3455","5107040",Primavera do Leste,42802,40804,95.331994,1998,1.023586,"5107040",
"3456","4124400",Santo Antônio do Sudoeste,18521,12168,65.698396,6353,0.512479,"4124400",
"3457","3502507",Aparecida,35483,35048,98.774061,435,0.235309,"3502507",
"3458","5107065",Querência,10621,4882,45.96554,5739,5.556404,"5107065",
"3459","3112000",Candeias,15393,10220,66.393815,5173,0.896242,"3112000",
"3460","5107107",São José dos Quatro Marcos,18848,14141,75.026528,4707,-0.624562,"5107107",
"3461","3502705",Apiaí,25112,18164,72.331953,6948,-1.114784,"3502705",
"3462","1721208",Tocantinópolis,21183,17268,81.518199,3915,-1.031108,"1721208",
"3463","4124707",São Jerônimo da Serra,11524,5865,50.893787,5659,-0.277064,"4124707",
"3464","4124806",São João,10833,6324,58.377181,4509,-0.483706,"4124806",
"3465","3112307",Capelinha,32850,22828,69.491629,10022,0.724621,"3112307",
"3466","4125001",São João do Ivaí,11774,8920,75.760149,2854,-1.615664,"4125001",
"3467","1722107",Xambioá,10834,8815,81.364224,2019,-1.609328,"1722107",
"3468","2510907",Paulista,11601,5183,44.677183,6418,0.419477,"2510907",
"3469","4125100",São João do Triunfo,13509,3792,28.070175,9717,1.210252,"4125100",
"3470","3112604",Capinópolis,15234,14078,92.411711,1156,0.804551,"3112604",
"3471","2100154",Água Doce do Maranhão,11811,2987,25.289984,8824,2.848328,"2100154",
"3472","2511202",Pedras de Fogo,26227,15364,58.580852,10863,0.200964,"2511202",
"3473","5107305",São José do Rio Claro,17138,13419,78.299685,3719,4.327469,"5107305",
"3474","2100204",Alcântara,21212,5871,27.67773,15341,-0.053091,"2100204",
"3475","3112703",Capitão Enéas,13916,11348,81.546421,2568,0.852688,"3112703",
"3476","2511301",Piancó,15812,11043,69.839363,4769,0.8794,"2511301",
"3477","2100303",Aldeias Altas,21589,10766,49.867988,10823,1.974846,"2100303",
"3478","2511400",Picuí,18669,11193,59.955006,7476,0.605931,"2511400",
"3479","2511509",Pilar,11234,7610,67.740787,3624,1.284298,"2511509",
"3480","2100436",Alto Alegre do Maranhão,21930,14933,68.093935,6997,1.208037,"2100436",
"3481","3113008",Caraí,21477,6856,31.922522,14621,0.334348,"3113008",
"3482","5107701",Rosário Oeste,17745,10335,58.241758,7410,-0.78769,"5107701",
"3483","3503604",Areiópolis,10562,9525,90.181784,1037,0.365053,"3503604",
"3484","2100477",Alto Alegre do Pindaré,31943,9395,29.411765,22548,0.815781,"2100477",
"3485","4125605",São Mateus do Sul,39019,23977,61.44955,15042,0.930702,"4125605",
"3486","2100501",Alto Parnaíba,10177,6212,61.039599,3965,0.004212,"2100501",
"3487","3113206",Carandaí,22192,16935,76.311283,5257,0.752803,"3113206",
"3488","2511806",Pirpirituba,10211,7744,75.839781,2467,0.018201,"2511806",
"3489","4125704",São Miguel do Iguaçu,25257,14759,58.435285,10498,0.47555,"4125704",
"3490","3503802",Artur Nogueira,39402,36224,91.93442,3178,2.5104,"3503802",
"3491","3113305",Carangola,31828,25194,79.156717,6634,-0.041673,"3113305",
"3492","2511905",Pitimbu,15975,9439,59.086072,6536,1.97927,"2511905",
"3493","5107800",Santo Antônio do Leverger,19032,6317,33.191467,12715,3.037859,"5107800",
"3494","2100600",Amarante do Maranhão,35540,14157,39.83399,21383,1.835155,"2100600",
"3495","2512002",Pocinhos,15939,8809,55.266955,7130,0.986995,"2512002",
"3496","5107859",São Félix do Araguaia,10540,5990,56.83112,4550,-0.197669,"5107859",
"3497","2100709",Anajatuba,23912,6448,26.96554,17464,0.570811,"2100709",
"3498","3113503",Carbonita,10108,7116,70.399683,2992,1.725809,"3113503",
"3499","5107875",Sapezal,12887,10465,81.205866,2422,7.307053,"5107875",
"3500","2100808",Anapurus,12552,6096,48.565966,6456,2.893643,"2100808",
"3501","3113701",Carlos Chagas,20641,13128,63.60157,7513,-0.902903,"3113701",
"3502","2512101",Pombal,31432,24237,77.109315,7195,-0.235022,"2512101",
"3503","3504206",Auriflama,13688,12595,92.014904,1093,0.183988,"3504206",
"3504","5107941",Tabaporã,10212,5051,49.461418,5161,-0.851553,"5107941",
"3505","3113909",Carmo da Cachoeira,11547,8433,73.031956,3114,-0.065399,"3113909",
"3506","2100907",Araioses,37616,10012,26.616333,27604,1.073879,"2100907",
"3507","2512309",Princesa Isabel,19254,13072,67.892386,6182,0.782984,"2512309",
"3508","2100956",Arame,27095,10978,40.5167,16117,-1.370537,"2100956",
"3509","3114006",Carmo da Mata,10899,8355,76.658409,2544,0.67175,"3114006",
"3510","2512408",Puxinanã,12843,3857,30.031924,8986,0.997468,"2512408",
"3511","3114105",Carmo de Minas,13593,8777,64.569999,4816,1.152776,"3114105",
"3512","2101004",Arari,27673,16383,59.20211,11290,0.693564,"2101004",
"3513","5108055",Terra Nova do Norte,14553,5773,39.668797,8780,0.872922,"5108055",
"3514","4126306",Sengés,19199,14898,77.597792,4301,1.104577,"4126306",
"3515","3114204",Carmo do Cajuru,18845,16102,85.444415,2743,1.349617,"3114204",
"3516","2101103",Axixá,14233,1830,12.857444,12403,4.96021,"2101103",
"3517","3114303",Carmo do Paranaíba,30426,25380,83.4155,5046,0.461979,"3114303",
"3518","2512705",Remígio,16693,11656,69.825675,5037,1.622872,"2512705",
"3519","3114402",Carmo do Rio Claro,19379,13759,70.999536,5620,-0.257549,"3114402",
"3520","2101251",Bacabeira,14537,3150,21.668845,11387,4.734358,"2101251",
"3521","4126504",Sertanópolis,15390,13426,87.238467,1964,0.227622,"4126504",
"3522","2101301",Bacuri,15500,7755,50.032258,7745,-0.028539,"2101301",
"3523","3114501",Carmópolis de Minas,15627,10497,67.172202,5130,1.227322,"3114501",
"3524","3504909",Bananal,10171,7960,78.261725,2211,0.66039,"3504909",
"3525","4126603",Siqueira Campos,16535,12068,72.984578,4467,0.470972,"4126603",
"3526","5108600",Vila Rica,18815,13597,72.266808,5218,2.729058,"5108600",
"3527","4126678",Tamarana,10438,5331,51.073002,5107,1.033703,"4126678",
"3528","3505203",Bariri,30853,29328,95.057207,1525,1.280433,"3505203",
"3529","2101509",Barão de Grajaú,16542,8674,52.436223,7868,1.075056,"2101509",
"3530","3505302",Barra Bonita,34948,34226,97.934073,722,-0.218407,"3505302",
"3531","4126801",Tapejara,14409,12507,86.799917,1902,1.347791,"4126801",
"3532","2101707",Barreirinhas,47466,17680,37.247714,29786,2.59662,"2101707",
"3533","2512903",Rio Tinto,22982,12919,56.213558,10063,0.424204,"2512903",
"3534","2513109",Salgado de São Félix,12440,5199,41.792605,7241,0.460836,"2513109",
"3535","4107009",Curiúva,14213,9093,63.976641,5120,1.389851,"4107009",
"3536","3505609",Barrinha,25565,25203,98.584002,362,0.782796,"3505609",
"3537","4127205",Terra Boa,14547,12001,82.49811,2546,-0.090997,"4127205",
"3538","5200100",Abadiânia,12537,7741,61.745234,4796,1.301538,"5200100",
"3539","2101905",Bequimão,20701,5516,26.646056,15185,0.710561,"2101905",
"3540","4127304",Terra Rica,14268,11331,79.415475,2937,0.480696,"4127304",
"3541","3505807",Bastos,20578,17516,85.120031,3062,-0.00694,"3505807",
"3542","5200134",Acreúna,18470,16343,88.484028,2127,0.131402,"5200134",
"3543","4127403",Terra Roxa,16083,12010,74.675123,4073,-0.191278,"4127403",
"3544","4127502",Tibagi,18619,11136,59.809872,7483,0.142756,"4127502",
"3545","2102002",Bom Jardim,37531,14637,38.99976,22894,1.221136,"2102002",
"3546","3115508",Caxambu,20935,20359,97.248627,576,-0.789248,"3115508",
"3547","2513406",Santa Luzia,14209,12852,90.449715,1357,0.199648,"2513406",
"3548","4127601",Tijucas do Sul,13072,1803,13.79284,11269,0.920361,"4127601",
"3549","2102036",Bom Jesus das Selvas,22695,11242,49.53514,11453,4.618637,"2102036",
"3550","2102077",Bom Lugar,12814,2774,21.648197,10040,1.514774,"2102077",
"3551","3506300",Bernardino de Campos,10430,9302,89.185043,1128,-0.391018,"3506300",
"3552","5200308",Alexânia,19902,16560,83.207718,3342,-0.10365,"5200308",
"3553","2102101",Brejo,31001,11484,37.043966,19517,1.719776,"2102101",
"3554","4127858",Três Barras do Paraná,11605,5265,45.368376,6340,-0.26431,"4127858",
"3555","2102200",Buriti,25223,8091,32.077865,17132,0.637253,"2102200",
"3556","2102309",Buriti Bravo,22224,16010,72.039237,6214,0.510364,"2102309",
"3557","3116100",Chapada do Norte,15427,5185,33.609905,10242,0.188469,"3116100",
"3558","3506607",Biritiba-Mirim,27445,23750,86.53671,3695,1.544454,"3506607",
"3559","3116159",Chapada Gaúcha,10237,5308,51.851128,4929,5.010818,"3116159",
"3560","2513901",São Bento,29052,22301,76.762357,6751,1.473235,"2513901",
"3561","4127965",Turvo,13987,4729,33.809966,9258,-0.542625,"4127965",
"3562","3506706",Boa Esperança do Sul,13141,11668,88.790807,1473,0.633217,"3506706",
"3563","2102358",Buritirana,12553,4181,33.306779,8372,-1.366321,"2102358",
"3564","4128005",Ubiratã,21141,17405,82.328177,3736,-0.944452,"4128005",
"3565","3506805",Bocaina,10244,9217,89.974619,1027,1.171442,"3506805",
"3566","2102507",Cajari,12753,4058,31.819964,8695,-0.709772,"2102507",
"3567","2102556",Campestre do Maranhão,12144,9483,78.087945,2661,0.755177,"2102556",
"3568","3116605",Cláudio,24465,19176,78.381361,5289,1.189171,"3116605",
"3569","4128401",Uraí,11459,9165,79.980801,2294,-0.509329,"4128401",
"3570","5201306",Anicuns,17633,15156,85.952475,2477,-0.876634,"5201306",
"3571","2102606",Cândido Mendes,18638,10971,58.863612,7667,1.697825,"2102606",
"3572","4128500",Wenceslau Braz,18598,14579,78.390149,4019,-0.717152,"4128500",
"3573","2102705",Cantanhede,18781,11805,62.856078,6976,0.839892,"2102705",
"3574","4128534",Ventania,10261,6758,65.861027,3503,3.575483,"4128534",
"3575","2102754",Capinzal do Norte,10353,4434,42.828166,5919,-0.25946,"2102754",
"3576","3507407",Borborema,13701,11988,87.497263,1713,0.541208,"3507407",
"3577","2102804",Carolina,24346,15068,61.89107,9278,0.21006,"2102804",
"3578","3117108",Conceição da Aparecida,10069,5876,58.357334,4193,1.030053,"3117108",
"3579","2102903",Carutapera,20205,13821,68.40386,6384,1.170787,"2102903",
"3580","5201702",Aragarças,16668,16302,97.804176,366,0.065308,"5201702",
"3581","2514503",São José de Piranhas,18878,9774,51.774552,9104,0.78216,"2514503",
"3582","3117306",Conceição das Alagoas,20161,18881,93.651109,1280,2.332532,"3117306",
"3583","3117504",Conceição do Mato Dentro,18006,11585,64.339665,6421,-0.490846,"3117504",
"3584","3507803",Brodowski,18980,18454,97.228662,526,1.468235,"3507803",
"3585","2103174",Centro Novo do Maranhão,14953,4515,30.19461,10438,0.38712,"2103174",
"3586","3507902",Brotas,20881,18774,89.909487,2107,1.444893,"3507902",
"3587","3117702",Conceição do Rio Verde,12612,10922,86.600063,1690,0.390002,"3117702",
"3588","3508009",Buri,17499,13748,78.564489,3751,-0.10568,"3508009",
"3589","2103257",Cidelândia,12380,5059,40.864297,7321,0.668334,"2103257",
"3590","3117801",Conceição dos Ouros,10134,7598,74.975331,2536,1.824904,"3117801",
"3591","3508108",Buritama,14622,13680,93.557653,942,0.773739,"3508108",
"3592","2103406",Coelho Neto,43955,36845,83.824366,7110,0.579019,"2103406",
"3593","2515104",São Sebastião de Lagoa de Roça,10904,4285,39.297506,6619,1.206477,"2515104",
"3594","4200101",Abelardo Luz,16332,7714,47.232427,8618,-0.094113,"4200101",
"3595","5203302",Bela Vista de Goiás,20488,14193,69.274697,6295,0.924366,"5203302",
"3596","2103505",Colinas,35499,22576,63.596158,12923,-0.121742,"2103505",
"3597","3118007",Congonhas,43499,42130,96.852801,1369,0.759173,"3118007",
"3598","2103554",Conceição do Lago-Açu,14059,6513,46.326197,7546,3.875007,"2103554",
"3599","2515302",Sapé,46172,35332,76.522568,10840,-0.360159,"2515302",
"3600","5203500",Bom Jesus de Goiás,19225,17925,93.237971,1300,2.424465,"5203500",
"3601","3508603",Cachoeira Paulista,31233,25453,81.493933,5780,1.992074,"3508603",
"3602","2103703",Cururupu,33886,22255,65.67609,11631,0.058738,"2103703",
"3603","2515500",Serra Branca,12364,8593,69.500162,3771,0.103258,"2515500",
"3604","2103752",Davinópolis,11751,9708,82.614246,2043,-0.621295,"2103752",
"3605","3508702",Caconde,18391,12219,66.440107,6172,0.010102,"3508702",
"3606","3118403",Conselheiro Pena,21684,17090,78.813872,4594,-0.032897,"3118403",
"3607","3508801",Cafelândia,16015,13750,85.857009,2265,0.199613,"3508801",
"3608","2103802",Dom Pedro,21438,14378,67.067823,7060,-0.340496,"2103802",
"3609","2103901",Duque Bacelar,10336,4926,47.658669,5410,1.345272,"2103901",
"3610","2104008",Esperantinópolis,18564,9443,50.86727,9121,-1.894796,"2104008",
"3611","2104057",Estreito,26323,18588,70.615051,7735,1.990946,"2104057",
"3612","3118809",Coração de Jesus,26025,14138,54.324688,11887,0.163546,"3118809",
"3613","3509254",Cajati,28171,19932,70.753612,8239,-0.524333,"3509254",
"3614","2516003",Solânea,27189,18960,69.734084,8229,-1.700815,"2516003",
"3615","2104099",Formosa da Serra Negra,16633,4814,28.942464,11819,2.72354,"2104099",
"3616","3119104",Corinto,22591,20127,89.093002,2464,-1.178674,"3119104",
"3617","2516102",Soledade,13076,9471,72.430407,3605,1.160993,"2516102",
"3618","3509403",Cajuru,22589,19949,88.312896,2640,1.201684,"3509403",
"3619","2104107",Fortaleza dos Nogueiras,11536,6778,58.755201,4758,0.294452,"2104107",
"3620","3119203",Coroaci,10748,5167,48.07406,5581,-0.071569,"3119203",
"3621","3119302",Coromandel,27109,21162,78.062636,5947,-0.179457,"3119302",
"3622","2104206",Fortuna,14463,8961,61.9581,5502,-0.130684,"2104206",
"3623","5204300",Caçu,10754,8445,78.528919,2309,0.240074,"5204300",
"3624","2104305",Godofredo Viana,10350,7577,73.207729,2773,5.758769,"2104305",
"3625","2516300",Sumé,16353,11861,72.531034,4492,1.207671,"2516300",
"3626","5204409",Caiapônia,15382,11404,74.138604,3978,0.676405,"5204409",
"3627","2104404",Gonçalves Dias,16420,7393,45.024361,9027,-0.317828,"2104404",
"3628","3509700",Campos do Jordão,44212,43950,99.407401,262,-0.012918,"3509700",
"3629","2516508",Taperoá,14657,8522,58.142867,6135,1.39868,"2516508",
"3630","2104552",Governador Edison Lobão,14049,5645,40.180796,8404,3.70431,"2104552",
"3631","2516607",Tavares,13997,6144,43.89512,7853,0.428779,"2516607",
"3632","3509908",Cananéia,11924,9863,82.715532,2061,-0.440221,"3509908",
"3633","2104602",Governador Eugênio Barros,15829,4358,27.531746,11471,1.132621,"2104602",
"3634","2516706",Teixeira,13628,8872,65.101262,4756,1.891149,"2516706",
"3635","3510005",Cândido Mota,29503,27657,93.743009,1846,0.108448,"3510005",
"3636","2104651",Governador Newton Bello,11164,3779,33.849875,7385,-0.793182,"2104651",
"3637","2104677",Governador Nunes Freire,23935,14635,61.144767,9300,-1.132278,"2104677",
"3638","2516904",Uiraúna,14388,9933,69.036697,4455,0.722404,"2516904",
"3639","5204904",Campos Belos,18148,15844,87.304386,2304,0.898096,"5204904",
"3640","3510203",Capão Bonito,45067,37506,83.222757,7561,-0.516929,"3510203",
"3641","3510302",Capela do Alto,15924,13062,82.027129,2862,1.602433,"3510302",
"3642","3120201",Cristais,10521,8091,76.903336,2430,1.441556,"3120201",
"3643","2104909",Guimarães,12377,5114,41.318575,7263,-0.301054,"2104909",
"3644","3510401",Capivari,43656,35963,82.378138,7693,0.737257,"3510401",
"3645","2105005",Humberto de Campos,24243,7734,31.901992,16509,1.889317,"2105005",
"3646","2105104",Icatu,24363,5695,23.375611,18668,1.80938,"2105104",
"3647","3120508",Cristina,10901,5933,54.426199,4968,0.759029,"3120508",
"3648","2105153",Igarapé do Meio,11689,5225,44.700145,6464,2.487423,"2105153",
"3649","2600104",Afogados da Ingazeira,33943,25385,74.787143,8558,0.437261,"2600104",
"3650","3510708",Cardoso,11283,10217,90.552158,1066,-0.401177,"3510708",
"3651","2105203",Igarapé Grande,10671,6001,56.236529,4670,1.284463,"2105203",
"3652","2600203",Afrânio,16451,4931,29.973862,11520,1.314322,"2600203",
"3653","5205406",Ceres,18591,17687,95.137432,904,-2.508292,"5205406",
"3654","3510807",Casa Branca,24863,21962,88.33206,2901,-1.066008,"3510807",
"3655","2600302",Agrestina,21369,15522,72.637933,5847,0.924398,"2600302",
"3656","4202107",Barra Velha,18522,17463,94.282475,1059,2.548879,"4202107",
"3657","2105351",Itaipava do Grajaú,13184,3557,26.979672,9627,-0.168972,"2105351",
"3658","3120805",Cruzília,14601,13144,90.021231,1457,0.845856,"3120805",
"3659","2600401",Água Preta,29447,16934,57.506707,12513,0.452461,"2600401",
"3660","3511003",Castilho,15391,12280,79.786888,3111,0.418092,"3511003",
"3661","2600500",Águas Belas,37624,22637,60.166383,14987,0.378921,"2600500",
"3662","2105427",Itinga do Maranhão,24861,17951,72.205462,6910,1.037579,"2105427",
"3663","2600609",Alagoinha,13979,8090,57.872523,5889,1.569786,"2600609",
"3664","5205513",Cocalzinho de Goiás,14156,6084,42.978242,8072,-0.465516,"5205513",
"3665","2600708",Aliança,34647,17106,49.37224,17541,-1.006357,"2600708",
"3666","2105476",Jenipapo dos Vieiras,14763,2404,16.283953,12359,5.544076,"2105476",
"3667","2600807",Altinho,21704,12045,55.496683,9659,-0.277938,"2600807",
"3668","3511409",Cerqueira César,16157,14436,89.34827,1721,0.929277,"3511409",
"3669","2105500",João Lisboa,19923,14843,74.501832,5080,-2.966402,"2105500",
"3670","2600906",Amaraji,20133,15568,77.325784,4565,-0.80771,"2600906",
"3671","3511508",Cerquilho,34670,33045,95.312951,1625,2.329773,"3511508",
"3672","2105609",Joselândia,15555,4881,31.378978,10674,0.900377,"2105609",
"3673","4202453",Bombinhas,12352,12352,100,0,5.106951,"4202453",
"3674","3511607",Cesário Lange,13959,9319,66.759797,4640,1.152532,"3511607",
"3675","2601052",Araçoiaba,16223,12698,78.27159,3525,1.022414,"2601052",
"3676","5206206",Cristalina,36253,30155,83.179323,6098,0.871715,"5206206",
"3677","3511706",Charqueada,14340,13023,90.8159,1317,1.370179,"3511706",
"3678","2105708",Lago da Pedra,42562,26198,61.552559,16364,0.745743,"2105708",
"3679","5206404",Crixás,14486,11456,79.083253,3030,-0.183067,"5206404",
"3680","3512001",Colina,16930,15616,92.23863,1314,0.226492,"3512001",
"3681","2105906",Lago Verde,14553,5324,36.583522,9229,1.58281,"2105906",
"3682","2601300",Barra de Guabiraba,12681,10889,85.868622,1792,2.133445,"2601300",
"3683","3121605",Diamantina,44395,38955,87.746368,5440,0.04384,"3121605",
"3684","2105922",Lagoa do Mato,10213,4110,40.242828,6103,1.121529,"2105922",
"3685","2601409",Barreiros,41496,34865,84.020147,6631,0.838894,"2601409",
"3686","3512209",Conchal,23313,21612,92.703642,1701,0.396556,"3512209",
"3687","4202800",Braço do Norte,27627,22481,81.373294,5146,1.552924,"4202800",
"3688","3512308",Conchas,15358,11905,77.516604,3453,0.42959,"3512308",
"3689","3121803",Dionísio,10210,7763,76.033301,2447,0.026613,"3121803",
"3690","2601607",Belém de São Francisco,20404,12844,62.948441,7560,0.137986,"2601607",
"3691","3512407",Cordeirópolis,19100,17193,90.015707,1907,1.182666,"3512407",
"3692","2106003",Lima Campos,11353,6617,58.284154,4736,0.784048,"2106003",
"3693","3122009",Divino,19078,9707,50.880595,9371,0.502671,"3122009",
"3694","2601805",Betânia,11504,3334,28.981224,8170,0.249592,"2601805",
"3695","2106102",Loreto,10320,5293,51.28876,5027,0.416602,"2106102",
"3696","2602001",Bodocó,33315,10500,31.517335,22815,0.698336,"2602001",
"3697","2106300",Magalhães de Almeida,14173,7290,51.435829,6883,1.218439,"2106300",
"3698","2602100",Bom Conselho,43120,26448,61.335807,16672,0.347682,"2602100",
"3699","5207402",Edéia,10199,8464,82.988528,1735,-0.033572,"5207402",
"3700","2106326",Maracaçumé,17511,14461,82.582377,3050,2.366899,"2106326",
"3701","2602209",Bom Jardim,38825,14460,37.244044,24365,0.685124,"2602209",
"3702","2602308",Bonito,38912,25260,64.915707,13652,0.434042,"2602308",
"3703","3513108",Cravinhos,29248,28489,97.404951,759,0.415644,"3513108",
"3704","2106375",Maranhãozinho,11855,7667,64.673134,4188,4.964666,"2106375",
"3705","4203303",Campo Alegre,11362,6628,58.3348,4734,-0.337392,"4203303",
"3706","2106409",Mata Roma,13796,6294,45.621919,7502,2.258906,"2106409",
"3707","5207808",Firminópolis,10242,8181,79.876977,2061,0.473309,"5207808",
"3708","2106508",Matinha,20396,7819,38.335948,12577,0.843757,"2106508",
"3709","2602605",Brejo da Madre de Deus,40214,29780,74.053812,10434,0.771025,"2602605",
"3710","2106607",Matões,28253,11748,41.581425,16505,0.955773,"2106607",
"3711","2602704",Buenos Aires,12933,7721,59.699992,5212,1.066972,"2602704",
"3712","4203600",Campos Novos,28368,22685,79.966864,5683,-0.180484,"4203600",
"3713","2106631",Matões do Norte,10568,3326,31.472369,7242,5.151622,"2106631",
"3714","2602803",Buíque,49523,18549,37.455324,30974,1.647917,"2602803",
"3715","3513603",Cunha,22860,11856,51.863517,11004,-0.142912,"3513603",
"3716","3513702",Descalvado,29344,23711,80.803571,5633,0.207646,"3513702",
"3717","2106706",Mirador,19377,7935,40.950612,11442,-0.384038,"2106706",
"3718","2603009",Cabrobó,28749,17640,61.358656,11109,1.039725,"2603009",
"3719","4203907",Capinzal,18421,15372,83.448238,3049,-1.136188,"4203907",
"3720","5208400",Goianápolis,11123,10078,90.605053,1045,0.594406,"5208400",
"3721","2106755",Miranda do Norte,17703,14915,84.251257,2788,1.344491,"2106755",
"3722","2603108",Cachoeirinha,17314,13083,75.563128,4231,0.226464,"2603108",
"3723","4203956",Capivari de Baixo,20047,18807,93.814536,1240,1.106317,"4203956",
"3724","2106805",Mirinzal,13733,8684,63.234545,5049,0.781147,"2106805",
"3725","2603207",Caetés,25152,6831,27.158874,18321,0.590185,"2603207",
"3726","3513900",Divinolândia,11063,7501,67.802585,3562,-1.17353,"3513900",
"3727","3123205",Dores do Indaiá,13934,12923,92.744366,1011,-0.45699,"3123205",
"3728","2106904",Monção,27503,10303,37.461368,17200,0.782273,"2106904",
"3729","2603306",Calçado,11278,3675,32.585565,7603,-0.534337,"2603306",
"3730","3514106",Dois Córregos,24212,23000,94.994218,1212,1.039014,"3514106",
"3731","2107100",Morros,17045,5297,31.076562,11748,2.242582,"2107100",
"3732","5208905",Goiás,24163,17353,71.816414,6810,-1.635744,"5208905",
"3733","2603504",Camocim de São Félix,15761,13235,83.973098,2526,0.599661,"2603504",
"3734","5209101",Goiatuba,31066,28422,91.489088,2644,-0.029396,"5209101",
"3735","3514403",Dracena,40854,38013,93.045969,2841,0.124402,"3514403",
"3736","3123601",Elói Mendes,24091,19572,81.241958,4519,1.340445,"3123601",
"3737","2603702",Canhotinho,23217,13235,57.005642,9982,-1.006132,"2603702",
"3738","5209200",Guapó,13415,10109,75.355945,3306,-0.468185,"5209200",
"3739","3514502",Duartina,12311,10728,87.141581,1583,-0.188871,"3514502",
"3740","4204251",Cocal do Sul,14517,12141,83.632982,2376,0.803619,"4204251",
"3741","2107357",Nova Olinda do Maranhão,17080,10928,63.981265,6152,1.247698,"2107357",
"3742","3123700",Engenheiro Caldas,10295,8478,82.350656,1817,1.389608,"3123700",
"3743","2603801",Capoeiras,19300,5714,29.606218,13586,-0.188066,"2603801",
"3744","2107407",Olho d'Água das Cunhãs,17327,8791,50.735846,8536,2.702094,"2107407",
"3745","2603900",Carnaíba,18316,7059,38.540074,11257,0.49316,"2603900",
"3746","2107456",Olinda Nova do Maranhão,12054,5050,41.894807,7004,2.518223,"2107456",
"3747","2603926",Carnaubeira da Penha,11650,1660,14.248927,9990,1.629067,"2603926",
"3748","4204400",Coronel Freitas,10200,5109,50.088235,5091,-0.460584,"4204400",
"3749","3514809",Eldorado,13813,6527,47.252588,7286,-0.327649,"3514809",
"3750","3123908",Entre Rios de Minas,13823,9334,67.525139,4489,0.755029,"3123908",
"3751","3514908",Elias Fausto,14502,11748,81.009516,2754,0.619934,"3514908",
"3752","2107605",Palmeirândia,18074,3416,18.900077,14658,0.657165,"2107605",
"3753","3124005",Ervália,17930,9030,50.362521,8900,0.748555,"3124005",
"3754","5209705",Hidrolândia,13860,9489,68.463203,4371,0.824294,"5209705",
"3755","4204509",Corupá,12706,9586,75.444672,3120,1.005012,"4204509",
"3756","2107704",Paraibano,19433,14954,76.951577,4479,1.218002,"2107704",
"3757","2604155",Casinhas,14096,1543,10.946368,12553,0.785199,"2604155",
"3758","4204558",Correia Pinto,14747,12109,82.111616,2638,-2.031956,"4204558",
"3759","2107803",Parnarama,34802,12198,35.04971,22604,0.996202,"2107803",
"3760","3124203",Espera Feliz,20767,12476,60.076082,8291,0.165499,"3124203",
"3761","2604205",Catende,33044,25287,76.525239,7757,0.7974,"2604205",
"3762","5209903",Iaciara,12630,8997,71.235154,3633,1.608728,"5209903",
"3763","2107902",Passagem Franca,17060,9610,56.330598,7450,2.034146,"2107902",
"3764","3124302",Espinosa,31233,17261,55.265264,13972,0.117182,"3124302",
"3765","2604304",Cedro,10224,5772,56.455399,4452,0.97749,"2604304",
"3766","4204707",Cunha Porã,10543,6156,58.389453,4387,0.432867,"4204707",
"3767","2108009",Pastos Bons,17504,11174,63.836837,6330,1.789733,"2108009",
"3768","2604403",Chã de Alegria,11613,8454,72.797727,3159,0.644926,"2604403",
"3769","5209952",Indiara,12613,10328,81.883771,2285,0.936839,"5209952",
"3770","3124500",Estiva,10903,4712,43.217463,6191,0.724134,"3124500",
"3771","2108058",Paulino Neves,12707,3244,25.529236,9463,1.403293,"2108058",
"3772","2604502",Chã Grande,17534,11790,67.240789,5744,-0.691728,"2604502",
"3773","4204806",Curitibanos,37264,34091,91.485079,3173,0.469897,"4204806",
"3774","5210000",Inhumas,44547,41988,94.255505,2559,0.210204,"5210000",
"3775","3515152",Engenheiro Coelho,12495,9227,73.845538,3268,3.184643,"3515152",
"3776","2108108",Paulo Ramos,16091,8672,53.893481,7419,-2.557119,"2108108",
"3777","2604601",Condado,23150,21254,91.809935,1896,0.864032,"2604601",
"3778","5210109",Ipameri,22840,19408,84.97373,3432,0.133307,"5210109",
"3779","3515186",Espírito Santo do Pinhal,40254,36040,89.531475,4214,-0.079949,"3515186",
"3780","2108207",Pedreiras,37868,31969,84.422203,5899,-0.718318,"2108207",
"3781","2604700",Correntes,16147,8908,55.168143,7239,-0.769367,"2604700",
"3782","4205001",Dionísio Cerqueira,14551,9344,64.215518,5207,0.299058,"4205001",
"3783","5210208",Iporá,30804,28076,91.144007,2728,-0.227933,"5210208",
"3784","2108256",Pedro do Rosário,21656,4807,22.197082,16849,2.714322,"2108256",
"3785","2604809",Cortês,11594,8298,71.571503,3296,-1.272084,"2604809",
"3786","2108306",Penalva,33384,13963,41.825425,19421,1.39481,"2108306",
"3787","3124906",Eugenópolis,10225,6659,65.124694,3566,0.658282,"3124906",
"3788","2604908",Cumaru,16370,6301,38.491142,10069,-7.137282,"2604908",
"3789","5210406",Itaberaí,30184,25113,83.199708,5071,1.141296,"5210406",
"3790","2108405",Peri Mirim,12212,3346,27.399279,8866,-0.966399,"2108405",
"3791","2605004",Cupira,22002,18653,84.778656,3349,-0.244962,"2605004",
"3792","3125101",Extrema,24574,21851,88.919183,2723,3.573653,"3125101",
"3793","2108454",Peritoró,18975,7430,39.156785,11545,1.298893,"2108454",
"3794","2605103",Custódia,32044,18968,59.193609,13076,0.960966,"2605103",
"3795","3515400",Fartura,14456,11218,77.600996,3238,-0.535804,"3515400",
"3796","2108504",Pindaré-Mirim,30881,22017,71.296266,8864,1.661322,"2108504",
"3797","2605152",Dormentes,15456,4900,31.702899,10556,1.005096,"2605152",
"3798","4205308",Faxinal dos Guedes,10329,7251,70.200407,3078,-0.591535,"4205308",
"3799","5210901",Itapaci,15938,14481,90.858326,1457,1.941312,"5210901",
"3800","2108702",Pio XII,21804,12363,56.700605,9441,-3.711559,"2108702",
"3801","2605301",Exu,30490,13051,42.804198,17439,-0.874288,"2605301",
"3802","2108801",Pirapemas,14966,9062,60.550581,5904,-0.149915,"2108801",
"3803","2605400",Feira Nova,19191,14504,75.577093,4687,0.251132,"2605400",
"3804","5211206",Itapuranga,24706,18965,76.76273,5741,-1.123843,"5211206",
"3805","2108900",Poção de Pedras,15831,7968,50.331628,7863,-4.824158,"2108900",
"3806","2109007",Porto Franco,18568,14088,75.872469,4480,1.405249,"2109007",
"3807","3125705",Felixlândia,13494,10546,78.153253,2948,0.775142,"3125705",
"3808","2605509",Ferreiros,10964,8725,79.578621,2239,0.312677,"2605509",
"3809","4205456",Forquilhinha,20609,16703,81.047115,3906,1.673961,"4205456",
"3810","2605608",Flores,21924,9285,42.350848,12639,0.73877,"2605608",
"3811","3516002",Flórida Paulista,11547,9906,85.788516,1641,0.557838,"3516002",
"3812","4205506",Fraiburgo,34812,30023,86.243249,4789,0.789264,"4205506",
"3813","2109106",Presidente Dutra,39899,28220,70.72859,11679,0.128842,"2109106",
"3814","3125903",Ferros,11305,4979,44.042459,6326,-1.23335,"3125903",
"3815","2605707",Floresta,26449,17189,64.989225,9260,0.965224,"2605707",
"3816","2109205",Presidente Juscelino,11699,4067,34.763655,7632,1.292771,"2109205",
"3817","3125952",Fervedouro,10228,4468,43.684005,5760,0.80317,"3125952",
"3818","2605806",Frei Miguelinho,14019,2863,20.422284,11156,1.108353,"2605806",
"3819","2605905",Gameleira,26167,18996,72.595254,7171,1.240781,"2605905",
"3820","5211800",Jaraguá,38462,31644,82.273413,6818,2.087109,"5211800",
"3821","4205704",Garopaba,16289,13676,83.9585,2613,3.089687,"4205704",
"3822","2109270",Presidente Sarney,15374,3702,24.079615,11672,1.641454,"2109270",
"3823","2606101",Glória do Goitá,27306,14186,51.951952,13120,-0.129077,"2606101",
"3824","2109403",Primeira Cruz,11945,4014,33.604018,7931,1.159409,"2109403",
"3825","3516705",Garça,41226,36978,89.695823,4248,-0.653446,"3516705",
"3826","2109502",Riachão,20964,9919,47.314444,11045,-0.012941,"2109502",
"3827","3126505",Francisco Badaró,10248,3030,29.566745,7218,-0.084746,"3126505",
"3828","5212204",Jussara,18710,14914,79.711384,3796,-0.971998,"5212204",
"3829","4206207",Gravatal,10500,4408,41.980952,6092,-0.400315,"4206207",
"3830","2606507",Iati,17665,7041,39.858477,10624,-0.021009,"2606507",
"3831","4206306",Guabiruba,16092,15020,93.338305,1072,3.122336,"4206306",
"3832","2109601",Rosário,37892,21908,57.816953,15984,1.704089,"2109601",
"3833","3126703",Francisco Sá,24397,14453,59.24089,9944,0.498739,"3126703",
"3834","2606606",Ibimirim,27173,14331,52.739852,12842,1.585331,"2606606",
"3835","4206405",Guaraciaba,10563,4706,44.551737,5857,-0.626409,"4206405",
"3836","3516903",General Salgado,10555,8860,83.94126,1695,-0.358872,"3516903",
"3837","2109809",Santa Helena,33682,14815,43.984918,18867,1.257885,"2109809",
"3838","2606903",Iguaraci,11863,5660,47.711371,6203,0.462429,"2606903",
"3839","3517208",Guaiçara,10316,9206,89.240016,1110,1.631707,"3517208",
"3840","5212808",Mara Rosa,10340,7640,73.887814,2700,-2.033196,"5212808",
"3841","2607000",Inajá,13881,7371,53.101362,6510,0.634316,"2607000",
"3842","4206702",Herval d'Oeste,18894,16662,88.186726,2232,-0.840525,"4206702",
"3843","3127008",Fronteira,13938,12558,90.09901,1380,6.407349,"3127008",
"3844","3517406",Guaíra,36431,34435,94.52115,1996,0.735224,"3517406",
"3845","2110039",Santa Luzia do Paruá,19568,11378,58.145953,8190,-0.352698,"2110039",
"3846","2110104",Santa Quitéria do Maranhão,28271,13167,46.574228,15104,0.061293,"2110104",
"3847","2607307",Ipubi,25645,16384,63.887697,9261,1.540749,"2607307",
"3848","4206900",Ibirama,16682,14030,84.102626,2652,0.777202,"4206900",
"3849","5213087",Minaçu,30550,26543,86.883797,4007,-1.353605,"5213087",
"3850","3517604",Guapiara,19861,7179,36.146216,12682,0.097482,"3517604",
"3851","2110203",Santa Rita,30770,15189,49.363016,15581,3.057072,"2110203",
"3852","5213103",Mineiros,44791,40413,90.225715,4378,1.988518,"5213103",
"3853","3517703",Guará,18552,17878,96.366969,674,-0.277194,"3517703",
"3854","2110237",Santana do Maranhão,10439,1768,16.936488,8671,-0.672622,"2110237",
"3855","2607505",Itaíba,26491,8946,33.76996,17545,-0.165,"2607505",
"3856","4207106",Ilhota,11451,6869,59.986027,4582,1.144773,"4207106",
"3857","2110278",Santo Amaro do Maranhão,11111,3222,28.99829,7889,2.091913,"2110278",
"3858","4207205",Imaruí,11613,3481,29.975028,8132,-2.028123,"4207205",
"3859","2110302",Santo Antônio dos Lopes,14201,5638,39.701429,8563,-0.052201,"2110302",
"3860","2607653",Itambé,34869,28486,81.694342,6383,-0.04621,"2607653",
"3861","4207304",Imbituba,36065,36065,100,0,0.145422,"4207304",
"3862","2110401",São Benedito do Rio Preto,17171,10385,60.479879,6786,0.62168,"2110401",
"3863","2607703",Itapetim,13824,7697,55.67853,6127,-0.937309,"2607703",
"3864","2110500",São Bento,37370,21662,57.966283,15708,2.323798,"2110500",
"3865","3518206",Guararapes,28578,26546,92.889635,2032,-0.131772,"3518206",
"3866","4207502",Indaial,47497,45618,96.043961,1879,2.413651,"4207502",
"3867","2110609",São Bernardo,25372,11125,43.847548,14247,1.589654,"2110609",
"3868","2607802",Itaquitinga,14967,11246,75.138638,3721,0.016237,"2607802",
"3869","5213806",Morrinhos,38834,33098,85.229438,5736,0.6974,"5213806",
"3870","2110708",São Domingos do Maranhão,32510,16371,50.356813,16139,-0.234633,"2110708",
"3871","2607950",Jaqueira,12053,7253,60.17589,4800,0.483306,"2607950",
"3872","3518503",Guareí,11358,7030,61.8947,4328,1.552337,"3518503",
"3873","3127602",Gouveia,11522,7922,68.755424,3600,-0.20536,"3127602",
"3874","2608008",Jataúba,14756,7864,53.293575,6892,0.100117,"2608008",
"3875","5214002",Mozarlândia,13080,10791,82.5,2289,2.259745,"5214002",
"3876","3518602",Guariba,32561,31899,97.966893,662,0.664913,"3518602",
"3877","2608057",Jatobá,13715,5710,41.633248,8005,0.604972,"2608057",
"3878","3127800",Grão Mogol,14428,5137,35.60438,9291,0.203637,"3127800",
"3879","2608107",João Alfredo,28423,12971,45.635577,15452,0.724186,"2608107",
"3880","2111003",São João Batista,18065,3909,21.638528,14156,-0.656189,"2111003",
"3881","2608206",Joaquim Nabuco,15941,11320,71.011856,4621,0.014347,"2608206",
"3882","2111029",São João do Carú,12177,4586,37.661164,7591,-1.457423,"2111029",
"3883","3128006",Guanhães,29139,23067,79.161948,6072,0.659807,"3128006",
"3884","2608255",Jucati,10442,2516,24.095001,7926,1.066011,"2608255",
"3885","2111052",São João do Paraíso,11225,5052,45.006682,6173,1.145203,"2111052",
"3886","3128105",Guapé,12965,6375,49.170845,6590,-0.701611,"3128105",
"3887","2608305",Jupi,13607,7028,51.649886,6579,1.418975,"2608305",
"3888","4207908",Irineópolis,10219,3251,31.813289,6968,0.697044,"4207908",
"3889","5214606",Niquelândia,38147,29028,76.095106,9119,-0.158523,"5214606",
"3890","2111078",São João do Soter,16576,6089,36.733832,10487,1.598847,"2111078",
"3891","3128204",Guaraciaba,10391,3173,30.536041,7218,0.178621,"3128204",
"3892","2608404",Jurema,14670,8614,58.718473,6056,0.93896,"2608404",
"3893","2111102",São João dos Patos,23474,19200,81.792622,4274,0.178979,"2111102",
"3894","2608453",Lagoa do Carro,14329,10292,71.826366,4037,1.278246,"2608453",
"3895","4208104",Itaiópolis,19548,9741,49.831185,9807,0.342269,"4208104",
"3896","3128303",Guaranésia,18047,16259,90.092536,1788,-0.451639,"3128303",
"3897","2608503",Lagoa do Itaenga,19970,17060,85.428142,2910,-0.143673,"2608503",
"3898","5214838",Nova Crixás,12193,7920,64.955302,4273,1.401684,"5214838",
"3899","2608602",Lagoa do Ouro,11626,5399,46.439016,6227,0.823973,"2608602",
"3900","4208302",Itapema,33656,32298,95.965058,1358,3.830781,"4208302",
"3901","2608701",Lagoa dos Gatos,15926,8308,52.166269,7618,-0.155112,"2608701",
"3902","4208401",Itapiranga,15151,7016,46.307174,8135,1.137161,"4208401",
"3903","2111409",São Luís Gonzaga do Maranhão,19253,6686,34.727056,12567,-2.369544,"2111409",
"3904","2608750",Lagoa Grande,20856,9505,45.574415,11351,1.23641,"2608750",
"3905","4208450",Itapoá,10561,9988,94.574377,573,2.575379,"4208450",
"3906","3519303",Ibaté,28002,27094,96.757374,908,0.811362,"3519303",
"3907","3128709",Guaxupé,47581,44433,93.383914,3148,0.164711,"3128709",
"3908","2111508",São Mateus do Maranhão,37893,27606,72.852506,10287,1.19935,"2111508",
"3909","2608800",Lajedo,33191,23510,70.832455,9681,0.429962,"2608800",
"3910","4208500",Ituporanga,20412,12999,63.683128,7413,0.661016,"4208500",
"3911","3519402",Ibirá,10324,9533,92.338241,791,1.276276,"3519402",
"3912","2111532",São Pedro da Água Branca,11082,9824,88.648258,1258,0.201422,"2111532",
"3913","2609006",Macaparana,23011,14508,63.048107,8503,0.325153,"2609006",
"3914","4208708",Jacinto Machado,10699,5074,47.424993,5625,-0.295568,"4208708",
"3915","3519600",Ibitinga,49635,47395,95.487056,2240,0.899256,"3519600",
"3916","2111607",São Raimundo das Mangabeiras,15915,11362,71.391769,4553,0.974955,"2111607",
"3917","2609105",Machados,11131,7600,68.277783,3531,1.797421,"2609105",
"3918","4208807",Jaguaruna,15631,11483,73.46299,4148,0.966708,"4208807",
"3919","2609154",Manari,16520,3256,19.709443,13264,3.450641,"2609154",
"3920","5215306",Orizona,14332,7647,53.356126,6685,1.32882,"5215306",
"3921","2609204",Maraial,12305,8663,70.402275,3642,-1.843723,"2609204",
"3922","2111706",São Vicente Ferrer,19647,5069,25.800377,14578,0.936471,"2111706",
"3923","3129301",Iapu,10783,7304,67.736252,3479,1.496675,"3129301",
"3924","2609303",Mirandiba,13229,6936,52.430267,6293,0.116084,"2609303",
"3925","4209003",Joaçaba,24270,22303,91.895344,1967,0.120658,"4209003",
"3926","3520004",Igaraçu do Tietê,22987,22878,99.525819,109,0.233983,"3520004",
"3927","3520103",Igarapava,26811,25112,93.663049,1699,0.481218,"3520103",
"3928","3129509",Ibiá,21962,18849,85.825517,3113,0.611838,"3129509",
"3929","2609501",Nazaré da Mata,29113,25783,88.561811,3330,-0.068998,"2609501",
"3930","2111763",Senador La Rocque,20728,8665,41.803358,12063,3.545476,"2111763",
"3931","5215702",Palmeiras de Goiás,21078,16653,79.006547,4425,2.42605,"5215702",
"3932","3520301",Iguape,28779,23026,80.009729,5753,0.689768,"3520301",
"3933","2111789",Serrano do Maranhão,10512,3578,34.037291,6934,2.049982,"2111789",
"3934","2609709",Orobó,21584,7035,32.593588,14549,-0.576209,"2609709",
"3935","3115102",Cássia,16955,14064,82.948983,2891,-0.269226,"3115102",
"3936","2111805",Sítio Novo,15518,4337,27.948189,11181,0.377556,"2111805",
"3937","3520400",Ilhabela,23632,23432,99.15369,200,1.815126,"3520400",
"3938","2609808",Orocó,13124,4369,33.290155,8755,2.7894,"2609808",
"3939","2111904",Sucupira do Norte,10199,4654,45.631925,5545,-0.248241,"2111904",
"3940","3520442",Ilha Solteira,24119,22714,94.174717,1405,0.073066,"3520442",
"3941","4209409",Laguna,49987,39672,79.364635,10315,0.711127,"4209409",
"3942","5216403",Paraúna,10595,7512,70.901369,3083,-0.318166,"5216403",
"3943","3130051",Icaraí de Minas,10308,2490,24.155995,7818,1.457582,"3130051",
"3944","2112100",Timbiras,26088,15791,60.529745,10297,-0.170233,"2112100",
"3945","2610202",Panelas,24714,12085,48.899409,12629,-0.653125,"2610202",
"3946","4209607",Lauro Muller,13671,10216,74.727525,3455,0.070209,"4209607",
"3947","2610301",Paranatama,11635,1998,17.172325,9637,1.688737,"2610301",
"3948","4209706",Lebon Régis,11701,7569,64.686779,4132,0.023219,"4209706",
"3949","2112233",Trizidela do Vale,18254,15482,84.814287,2772,1.540038,"2112233",
"3950","2610400",Parnamirim,19161,7591,39.61693,11570,-0.095069,"2610400",
"3951","3520905",Ipaussu,12913,11901,92.162937,1012,0.404744,"3520905",
"3952","2610509",Passira,27850,13078,46.958707,14772,-0.640856,"2610509",
"3953","5217104",Piracanjuba,23129,16640,71.944312,6489,-0.261597,"5217104",
"3954","2112308",Tuntum,37764,17574,46.536384,20190,0.92329,"2112308",
"3955","5217203",Piranhas,10925,8800,80.549199,2125,-1.664394,"5217203",
"3956","3130507",Ilicínea,11241,8434,75.028912,2807,0.935053,"3130507",
"3957","2112407",Turiaçu,32086,10140,31.602568,21946,0.359978,"2112407",
"3958","5217302",Pirenópolis,20298,12540,61.779486,7758,-0.6493,"5217302",
"3959","2112456",Turilândia,20034,9512,47.479285,10522,2.176501,"2112456",
"3960","2610806",Pedra,20069,11739,58.493198,8330,-0.123953,"2610806",
"3961","5217401",Pires do Rio,26695,24869,93.159768,1826,0.251897,"5217401",
"3962","2112506",Tutóia,46132,13515,29.296367,32617,2.914585,"2112506",
"3963","3521309",Ipuã,13639,13062,95.769485,577,2.004382,"3521309",
"3964","2112605",Urbano Santos,21686,14366,66.245504,7320,3.02481,"2112605",
"3965","2611002",Petrolândia,29850,21348,71.517588,8502,1.273264,"2611002",
"3966","5217708",Pontalina,16086,13077,81.294293,3009,-0.410573,"5217708",
"3967","3521408",Iracemápolis,17982,17477,97.191636,505,2.092873,"3521408",
"3968","2112704",Vargem Grande,43193,23149,53.594332,20044,3.17415,"2112704",
"3969","5218003",Porangatu,38331,32900,85.831311,5431,-0.461693,"5218003",
"3970","2112803",Viana,47304,25936,54.828344,21368,0.977552,"2112803",
"3971","2611200",Poção,11115,6801,61.187584,4314,-0.08071,"2611200",
"3972","3130903",Inhapim,24125,13859,57.446632,10266,-0.447828,"3130903",
"3973","2611309",Pombos,21723,14338,66.003775,7385,-1.027092,"2611309",
"3974","3521705",Itaberá,17441,10917,62.593888,6524,-1.149344,"3521705",
"3975","2112902",Vitória do Mearim,30826,14057,45.601116,16769,0.411258,"2112902",
"3976","2611408",Primavera,11828,7750,65.522489,4078,0.431278,"2611408",
"3977","4210506",Maravilha,21607,17459,80.802518,4148,2.226016,"4210506",
"3978","3521804",Itaí,21405,17680,82.597524,3725,0.246685,"3521804",
"3979","5218300",Posse,28384,21386,75.345265,6998,1.431438,"5218300",
"3980","2113009",Vitorino Freire,30177,14940,49.507903,15237,1.355922,"2113009",
"3981","2611507",Quipapá,24073,12168,50.546255,11905,1.199699,"2611507",
"3982","3521903",Itajobi,14133,11725,82.961862,2408,-0.097665,"3521903",
"3983","2114007",Zé Doca,44432,27514,61.923839,16918,-0.535565,"2114007",
"3984","5218508",Quirinópolis,37806,33492,88.589113,4314,0.498766,"5218508",
"3985","4210605",Massaranduba,13698,6397,46.700248,7301,1.244443,"4210605",
"3986","3131208",Ipanema,17046,13119,76.962337,3927,0.653695,"3131208",
"3987","5218607",Rialma,10407,9218,88.574998,1189,0.273388,"5218607",
"3988","2611705",Riacho das Almas,18202,8085,44.418196,10117,0.047179,"2611705",
"3989","2611804",Ribeirão,38581,30578,79.256629,8003,-1.019112,"2611804",
"3990","2611903",Rio Formoso,20803,12713,61.111378,8090,0.026811,"2611903",
"3991","2612000",Sairé,13685,7596,55.506028,6089,0.037637,"2612000",
"3992","5218904",Rubiataba,17859,15636,87.552495,2223,-0.181063,"5218904",
"3993","3131802",Itabirinha de Mantena,10307,7929,76.928301,2378,0.709979,"3131802",
"3994","3131901",Itabirito,41248,39590,95.980411,1658,1.216268,"3131901",
"3995","2612307",Saloá,15011,6873,45.786423,8138,0.004759,"2612307",
"3996","4211207",Morro da Fumaça,15304,12456,81.390486,2848,0.723383,"4211207",
"3997","2612406",Sanharó,17552,10142,57.782589,7410,1.441294,"2612406",
"3998","3522703",Itápolis,38537,34529,89.599606,4008,0.295197,"3522703",
"3999","3132107",Itacarambi,17573,13617,77.488192,3956,0.096296,"3132107",
"4000","2612455",Santa Cruz,13483,4037,29.941408,9446,2.602105,"2612455",
"4001","5219308",Santa Helena de Goiás,34770,32906,94.639057,1864,0.092788,"5219308",
"4002","3522802",Itaporanga,14173,10682,75.368659,3491,-0.18112,"3522802",
"4003","3132206",Itaguara,12205,9027,73.961491,3178,1.104137,"3132206",
"4004","2612471",Santa Cruz da Baixa Verde,11540,4556,39.480069,6984,0.827676,"2612471",
"4005","3522901",Itapuí,11516,10963,95.197985,553,1.507303,"3522901",
"4006","3132305",Itaipé,11454,4804,41.94168,6650,0.908967,"3132305",
"4007","2612554",Santa Filomena,13704,2339,17.068009,11365,1.77621,"2612554",
"4008","4211504",Nova Trento,11277,8407,74.549969,2870,1.948611,"4211504",
"4009","3132503",Itamarandiba,31687,20678,65.257045,11009,1.075916,"3132503",
"4010","2612604",Santa Maria da Boa Vista,39330,14147,35.969997,25183,0.909781,"2612604",
"4011","4211603",Nova Veneza,12484,8368,67.029798,4116,1.165955,"4211603",
"4012","3523206",Itararé,48577,44783,92.189719,3794,0.609525,"3523206",
"4013","2612703",Santa Maria do Cambucá,12307,2986,24.262615,9321,0.677306,"2612703",
"4014","3523305",Itariri,15050,14004,93.049834,1046,1.443937,"3523305",
"4015","3132701",Itambacuri,22413,14416,64.319814,7997,-0.161485,"3132701",
"4016","5219704",Santa Terezinha de Goiás,11500,8637,75.104348,2863,-0.623886,"5219704",
"4017","4211702",Orleans,20834,14484,69.520975,6350,0.563082,"4211702",
"4018","4211751",Otacílio Costa,15674,14251,90.921271,1423,1.633862,"4211751",
"4019","3523503",Itatinga,17506,15634,89.306523,1872,1.804569,"3523503",
"4020","3132909",Itamogi,10766,8088,75.125395,2678,0.057189,"3132909",
"4021","2613008",São Bento do Una,47081,24902,52.891825,22179,0.533401,"2613008",
"4022","3523602",Itirapina,11394,10075,88.423732,1319,-1.687975,"3523602",
"4023","3133006",Itamonte,13726,7784,56.709894,5942,1.701482,"3133006",
"4024","2613107",São Caitano,34544,25507,73.839162,9037,0.471104,"2613107",
"4025","3133105",Itanhandu,14327,11620,81.105605,2707,1.493274,"3133105",
"4026","2613206",São João,20963,8741,41.697276,12222,0.85952,"2613206",
"4027","3133204",Itanhomi,11837,8182,69.122244,3655,0.323978,"3133204",
"4028","2613305",São Joaquim do Monte,20794,13421,64.542657,7373,0.671726,"2613305",
"4029","3133303",Itaobim,20927,15751,75.266402,5176,-0.23265,"3133303",
"4030","2613404",São José da Coroa Grande,17027,12221,71.774241,4806,2.86626,"2613404",
"4031","3133402",Itapagipe,13935,9384,67.341227,4551,2.364609,"3133402",
"4032","3524006",Itupeva,36679,30116,82.106928,6563,4.943201,"3524006",
"4033","2613503",São José do Belmonte,32664,15258,46.711976,17406,0.450615,"2613503",
"4034","3524105",Ituverava,38441,36152,94.04542,2289,0.834733,"3524105",
"4035","3133501",Itapecerica,20466,15768,77.044855,4698,-0.525554,"3133501",
"4036","2613602",São José do Egito,30378,19550,64.355784,10828,0.435427,"2613602",
"4037","5220108",São Luís de Montes Belos,26625,23281,87.440376,3344,0.130525,"5220108",
"4038","4212106",Palmitos,16030,9386,58.552714,6644,-0.003564,"4212106",
"4039","2613800",São Vicente Ferrer,16582,10757,64.871547,5825,0.508131,"2613800",
"4040","5220207",São Miguel do Araguaia,22306,18067,80.996145,4239,-0.308064,"5220207",
"4041","4212205",Papanduva,17038,8865,52.030755,8173,0.182432,"4212205",
"4042","3133758",Itaú de Minas,14514,14186,97.740113,328,0.837416,"3133758",
"4043","2614006",Serrita,18189,5788,31.821431,12401,0.270731,"2614006",
"4044","3524600",Jacupiranga,16061,8460,52.67418,7601,-0.842548,"3524600",
"4045","2614105",Sertânia,33954,17000,50.067739,16954,1.0057,"2614105",
"4046","5220405",São Simão,13616,13254,97.341363,362,0.067329,"5220405",
"4047","3134004",Itinga,14512,6328,43.605292,8184,0.623634,"3134004",
"4048","2614204",Sirinhaém,36290,19214,52.945715,17076,1.346726,"2614204",
"4049","3524808",Jales,47379,44399,93.710294,2980,0.364984,"3524808",
"4050","2614303",Moreilândia,10417,6262,60.113276,4155,-0.923515,"2614303",
"4051","5220603",Silvânia,18211,11768,64.620284,6443,-1.56638,"5220603",
"4052","4212502",Penha,20767,18931,91.15905,1836,2.327301,"4212502",
"4053","3134400",Iturama,31089,29186,93.878864,1903,1.091524,"3134400",
"4054","2614600",Tabira,25780,18340,71.140419,7440,0.988287,"2614600",
"4055","3525201",Jarinu,20524,16079,78.342428,4445,2.69236,"3525201",
"4056","2614709",Tacaimbó,12085,6567,54.340091,5518,-0.959762,"2614709",
"4057","4212809",Piçarras,13740,12477,90.80786,1263,3.34826,"4212809",
"4058","3134608",Jaboticatubas,15363,9218,60.001302,6145,1.831609,"3134608",
"4059","2614808",Tacaratu,20486,8961,43.742068,11525,2.617927,"2614808",
"4060","4212908",Pinhalzinho,14659,11903,81.199263,2756,2.471661,"4212908",
"4061","3134707",Jacinto,12364,8971,72.557425,3393,0.324218,"3134707",
"4062","2614857",Tamandaré,18090,12504,69.121061,5586,0.655736,"2614857",
"4063","3525508",Joanópolis,10613,10613,100,0,0.277654,"3525508",
"4064","2615003",Taquaritinga do Norte,21317,15309,71.815922,6008,1.091586,"2615003",
"4065","3134905",Jacutinga,20245,16591,81.951099,3654,0.907787,"3134905",
"4066","3525706",José Bonifácio,30558,27665,90.532757,2893,0.893132,"3525706",
"4067","4213203",Pomerode,25100,21849,87.047809,3251,1.817305,"4213203",
"4068","3135050",Jaíba,30201,15471,51.226781,14730,1.460051,"3135050",
"4069","2615409",Toritama,29835,28718,96.256075,1117,4.584441,"2615409",
"4070","2615508",Tracunhaém,12713,10683,84.032093,2030,0.363697,"2615508",
"4071","4213401",Ponte Serrada,10886,7701,70.742238,3185,0.433933,"4213401",
"4072","3526001",Junqueirópolis,17507,15129,86.416862,2378,0.416485,"3526001",
"4073","2615607",Trindade,24477,19629,80.193651,4848,1.582075,"2615607",
"4074","5221601",Uruaçu,33160,30122,90.838359,3038,-0.158392,"5221601",
"4075","4213500",Porto Belo,13200,12377,93.765152,823,3.039555,"4213500",
"4076","3526100",Juquiá,19199,12299,64.060628,6900,-0.943335,"3526100",
"4077","2615706",Triunfo,15177,7183,47.328194,7994,0.039596,"2615706",
"4078","4213609",Porto União,32142,27328,85.022712,4814,0.126867,"4213609",
"4079","5221700",Uruana,13632,11240,82.453052,2392,-0.316626,"5221700",
"4080","2615805",Tupanatinga,18505,6904,37.308835,11601,-1.656977,"2615805",
"4081","4213708",Pouso Redondo,13699,7908,57.726841,5791,1.665736,"4213708",
"4082","3526407",Laranjal Paulista,24328,22253,91.470733,2075,1.352149,"3526407",
"4083","2616001",Venturosa,15555,9544,61.356477,6011,2.085903,"2616001",
"4084","5222005",Vianópolis,12138,9059,74.633383,3079,1.027216,"5222005",
"4085","3135506",Jequeri,12927,6899,53.368918,6028,-0.782739,"3135506",
"4086","4214003",Presidente Getúlio,13543,9073,66.994019,4470,1.345995,"4214003",
"4087","2616209",Vertentes,16961,8218,48.452332,8743,1.812475,"2616209",
"4088","3135803",Jequitinhonha,23314,16748,71.836665,6566,0.255036,"3135803",
"4089","2616308",Vicência,27324,11132,40.740741,16192,-0.758596,"2616308",
"4090","4214201",Quilombo,10788,5525,51.214312,5263,0.06905,"4214201",
"4091","5213004",Maurilândia,10404,9944,95.578624,460,2.142867,"5213004",
"4092","3136009",Joaíma,14847,10330,69.576345,4517,0.284164,"3136009",
"4093","2616506",Xexéu,14212,9057,63.727836,5155,0.633965,"2616506",
"4094","2700102",Água Branca,19251,5344,27.759597,13907,0.446434,"2700102",
"4095","2700201",Anadia,17246,9105,52.794851,8141,-0.489757,"2700201",
"4096","3136306",João Pinheiro,42729,33843,79.203819,8886,0.463502,"3136306",
"4097","2700409",Atalaia,49651,24290,48.921472,25361,2.934128,"2700409",
"4098","3527405",Lucélia,18021,16673,92.519838,1348,-0.231692,"3527405",
"4099","3136504",Jordânia,10683,7790,72.919592,2893,1.144508,"3136504",
"4100","2700508",Barra de Santo Antônio,13640,12271,89.963343,1369,2.659035,"2700508",
"4101","4215000",Rio Negrinho,41788,37887,90.664784,3901,1.478878,"4215000",
"4102","2700706",Batalha,16113,11227,69.676659,4886,1.222654,"2700706",
"4103","4215109",Rodeio,10667,9177,86.031687,1490,0.390388,"4215109",
"4104","2701001",Boca da Mata,25054,16425,65.558394,8629,0.480663,"2701001",
"4105","3528007",Macatuba,16134,15665,97.093095,469,0.342894,"3528007",
"4106","2701100",Branquinha,11396,6685,58.660934,4711,0.089322,"2701100",
"4107","2701308",Cajueiro,20003,15986,79.918012,4017,0.756561,"2701308",
"4108","4215455",Sangão,10243,4844,47.290833,5399,3.359183,"4215455",
"4109","3137007",Ladainha,16455,4195,25.493771,12260,0.552897,"3137007",
"4110","2701407",Campo Alegre,45085,18420,40.856161,26665,1.356183,"2701407",
"4111","4215505",Santa Cecília,15217,13024,85.588487,2193,0.395794,"4215505",
"4112","3137205",Lagoa da Prata,43810,42829,97.760785,981,1.765764,"3137205",
"4113","2701605",Canapi,17598,5062,28.764632,12536,0.216167,"2701605",
"4114","2110906",São Francisco do Maranhão,14163,3715,26.230318,10448,1.395039,"2110906",
"4115","2701704",Capela,16753,12496,74.589626,4257,-1.553124,"2701704",
"4116","3528809",Maracaí,13129,11597,88.331175,1532,0.136758,"3528809",
"4117","3137403",Lagoa Dourada,11759,6434,54.715537,5325,0.336135,"3137403",
"4118","3137502",Lagoa Formosa,16444,11907,72.409389,4537,0.131874,"3137502",
"4119","2200202",Água Branca,15854,14252,89.895295,1602,1.266546,"2200202",
"4120","2702009",Coité do Nóia,10853,3598,33.152124,7255,-1.416748,"2702009",
"4121","2702108",Colônia Leopoldina,19320,14419,74.632505,4901,1.429261,"2702108",
"4122","3137700",Lajinha,17514,10682,60.991207,6832,-1.542955,"3137700",
"4123","3529203",Martinópolis,22696,19749,87.015333,2947,0.222266,"3529203",
"4124","3137809",Lambari,18442,13516,73.289231,4926,0.150404,"3137809",
"4125","2200301",Alto Longá,13607,6171,45.351657,7436,1.81161,"2200301",
"4126","2702306",Coruripe,49942,41814,83.725121,8128,0.317501,"2702306",
"4127","2200400",Altos,38263,26833,70.1278,11430,-0.316663,"2200400",
"4128","2702355",Craíbas,21765,6956,31.959568,14809,0.657569,"2702355",
"4129","2702405",Delmiro Gouveia,45989,33447,72.728261,12542,0.966331,"2702405",
"4130","4216008",São Carlos,10257,6703,65.350492,3554,1.309758,"4216008",
"4131","2200509",Amarante,17244,8932,51.797727,8312,0.301852,"2200509",
"4132","2702504",Dois Riachos,10840,4804,44.317343,6036,-0.294342,"2702504",
"4133","2702553",Estrela de Alagoas,16679,3753,22.501349,12926,0.292902,"2702553",
"4134","2702603",Feira Grande,21085,3276,15.537112,17809,-0.124718,"2702603",
"4135","4216206",São Francisco do Sul,37343,34856,93.340117,2487,2.093721,"4216206",
"4136","3529708",Miguelópolis,19893,17884,89.90097,2009,0.643913,"3529708",
"4137","3529807",Mineiros do Tietê,11702,11244,96.086139,458,0.361647,"3529807",
"4138","3138401",Leopoldina,49490,43929,88.763387,5561,-0.173998,"3138401",
"4139","2702801",Flexeiras,10477,7592,72.463491,2885,-1.895698,"2702801",
"4140","4216305",São João Batista,21972,16191,73.689241,5781,5.745093,"4216305",
"4141","3529906",Miracatu,22645,11047,48.783396,11598,0.166386,"3529906",
"4142","2702900",Girau do Ponciano,34618,10388,30.007511,24230,2.275185,"2702900",
"4143","3138609",Lima Duarte,15786,11495,72.817687,4291,0.070787,"3138609",
"4144","2703007",Ibateguara,15321,8771,57.248221,6550,0.203043,"2703007",
"4145","3530102",Mirandópolis,23857,20818,87.2616,3039,-1.186537,"3530102",
"4146","2201101",Avelino Lopes,11499,6334,55.083051,5165,2.573942,"2201101",
"4147","2703106",Igaci,25101,5943,23.676348,19158,-0.271908,"2703106",
"4148","3530201",Mirante do Paranapanema,16339,9583,58.65108,6756,0.110654,"3530201",
"4149","4216503",São Joaquim,23928,17050,71.255433,6878,0.669533,"4216503",
"4150","2201150",Baixa Grande do Ribeiro,10108,5524,54.649782,4584,3.812292,"2201150",
"4151","2703205",Igreja Nova,22891,4818,21.047573,18073,0.9325,"2703205",
"4152","2703304",Inhapi,17193,6282,36.538126,10911,-0.468851,"2703304",
"4153","4216701",São José do Cedro,13611,7671,56.358827,5940,-0.070124,"4216701",
"4154","2201200",Barras,43246,20933,48.404477,22313,0.803133,"2201200",
"4155","4216800",São José do Cerrito,10119,2386,23.579405,7733,-0.380953,"4216800",
"4156","4216909",São Lourenço do Oeste,21671,16290,75.169581,5381,1.410575,"4216909",
"4157","3138807",Luz,16963,14966,88.227318,1997,0.109964,"3138807",
"4158","4217006",São Ludgero,10218,8296,81.190057,1922,2.515422,"4217006",
"4159","2201507",Batalha,25696,8463,32.935087,17233,0.904117,"2201507",
"4160","2703809",Joaquim Gomes,21029,14037,66.750678,6992,-0.307985,"2703809",
"4161","4217204",São Miguel do Oeste,33658,29682,88.187058,3976,0.579397,"4217204",
"4162","3139201",Malacacheta,17821,10817,60.698053,7004,-1.095859,"3139201",
"4163","2704005",Junqueiro,24373,7517,30.841505,16856,0.321183,"2704005",
"4164","2704104",Lagoa da Canoa,17797,8874,49.862336,8923,-1.644924,"2704104",
"4165","3139300",Manga,20739,14283,68.870244,6456,-0.813262,"3139300",
"4166","2704203",Limoeiro de Anadia,25428,2145,8.435583,23283,0.672226,"2704203",
"4167","3531308",Monte Alto,43919,42305,96.325053,1614,0.099932,"3531308",
"4168","4217501",Seara,17111,11654,68.108234,5457,0.534729,"4217501",
"4169","3531407",Monte Aprazível,19662,17662,89.828095,2000,0.941993,"3531407",
"4170","3139508",Manhumirim,20065,16542,82.442063,3523,0.028511,"3139508",
"4171","2704401",Major Isidoro,18596,9168,49.300925,9428,0.757629,"2704401",
"4172","3531506",Monte Azul Paulista,19152,17691,92.371554,1461,-0.295585,"3531506",
"4173","2201903",Bom Jesus,19440,14328,73.703704,5112,2.89108,"2201903",
"4174","3139607",Mantena,26451,20380,77.048127,6071,-0.22533,"3139607",
"4175","2704500",Maragogi,24758,16223,65.526295,8535,1.81298,"2704500",
"4176","4217600",Siderópolis,12448,9597,77.096722,2851,0.427242,"4217600",
"4177","2704609",Maravilha,10156,4660,45.884206,5496,-4.173026,"2704609",
"4178","4217709",Sombrio,24337,16862,69.28545,7475,0.834277,"4217709",
"4179","3139805",Mar de Espanha,11088,10027,90.431097,1061,0.689905,"3139805",
"4180","2704708",Marechal Deodoro,44995,37452,83.235915,7543,3.292493,"2704708",
"4181","3139904",Maria da Fé,14182,7827,55.189677,6355,-0.42093,"3139904",
"4182","2704807",Maribondo,13802,9863,71.460658,3939,-1.317768,"2704807",
"4183","4217808",Taió,16743,8837,52.780266,7906,0.421696,"4217808",
"4184","3531902",Morro Agudo,25303,23633,93.399992,1670,-0.070375,"3531902",
"4185","2705002",Mata Grande,24503,5204,21.238216,19299,-0.30467,"2705002",
"4186","2202000",Buriti dos Lopes,19126,9633,50.365994,9493,0.400724,"2202000",
"4187","2705101",Matriz de Camaragibe,24600,20334,82.658537,4266,0.343224,"2705101",
"4188","4218004",Tijucas,27418,23043,84.043329,4375,2.227911,"4218004",
"4189","2705200",Messias,14987,13552,90.425035,1435,3.238626,"2705200",
"4190","4218202",Timbó,33172,30423,91.71289,2749,1.760184,"4218202",
"4191","3140506",Martinho Campos,12146,9991,82.257533,2155,0.393067,"3140506",
"4192","2705507",Murici,25456,20788,81.662476,4668,0.448474,"2705507",
"4193","4218301",Três Barras,17883,15185,84.913046,2698,0.621488,"4218301",
"4194","2705606",Novo Lino,11610,6971,60.043066,4639,1.619658,"2705606",
"4195","2705705",Olho d'Água das Flores,19814,13477,68.017563,6337,0.289558,"2705705",
"4196","3532603",Nhandeara,10211,8233,80.628734,1978,0.023807,"3532603",
"4197","2706000",Olivença,10478,2504,23.89769,7974,0.149501,"2706000",
"4198","2202208",Campo Maior,44504,32263,72.494607,12241,0.45034,"2202208",
"4199","2706109",Ouro Branco,11017,6605,59.9528,4412,1.282207,"2706109",
"4200","3140902",Matipó,16348,12481,76.34573,3867,0.049909,"3140902",
"4201","4218806",Turvo,10998,7213,65.584652,3785,0.14502,"4218806",
"4202","2202307",Canto do Buriti,20583,10422,50.634018,10161,1.637435,"2202307",
"4203","3141009",Mato Verde,12646,9190,72.6712,3456,-0.594495,"3141009",
"4204","2202406",Capitão de Campos,10822,6222,57.493994,4600,1.083001,"2202406",
"4205","2706406",Pão de Açúcar,23793,10427,43.823814,13366,-0.330616,"2706406",
"4206","4218905",Urubici,10409,7307,70.198866,3102,0.21735,"4218905",
"4207","3533007",Nova Granada,17635,16180,91.749362,1455,0.50838,"3533007",
"4208","2706422",Pariconha,10199,2707,26.541818,7492,0.159289,"2706422",
"4209","2202505",Caracol,10287,3807,37.007874,6480,3.583453,"2202505",
"4210","4219002",Urussanga,18569,10711,57.682158,7858,-0.120967,"4219002",
"4211","3141405",Medina,20530,14292,69.615197,6238,-0.750065,"3141405",
"4212","2706505",Passo de Camaragibe,13797,6889,49.931144,6908,0.043564,"2706505",
"4213","3141603",Mercês,10357,6783,65.491938,3574,0.415088,"3141603",
"4214","2202604",Castelo do Piauí,18428,11256,61.080964,7172,0.069185,"2202604",
"4215","2706802",Piaçabuçu,17329,10299,59.432166,7030,0.465246,"2706802",
"4216","3533502",Novo Horizonte,34161,31672,92.713914,2489,0.744746,"3533502",
"4217","3141801",Minas Novas,30504,12217,40.050485,18287,-0.066326,"3141801",
"4218","2202703",Cocal,26062,11062,42.444939,15000,1.09443,"2202703",
"4219","2706901",Pilar,31462,29914,95.079779,1548,0.119075,"2706901",
"4220","4219309",Videira,44357,38942,87.792231,5415,0.924747,"4219309",
"4221","3142007",Mirabela,12716,9813,77.170494,2903,0.185615,"3142007",
"4222","2707107",Piranhas,23765,13458,56.629497,10307,2.489508,"2707107",
"4223","3142106",Miradouro,10133,5481,54.090595,4652,0.522517,"3142106",
"4224","2707206",Poço das Trincheiras,12118,1915,15.802938,10203,-1.237849,"2707206",
"4225","4219507",Xanxerê,40054,36228,90.447895,3826,0.973028,"4219507",
"4226","3533908",Olímpia,47851,45092,94.234185,2759,0.561112,"3533908",
"4227","3142205",Miraí,12869,10082,78.343306,2787,0.440598,"3142205",
"4228","2707305",Porto Calvo,24997,18296,73.192783,6701,0.612522,"2707305",
"4229","2707404",Porto de Pedras,10110,5412,53.531157,4698,-0.179571,"2707404",
"4230","4219705",Xaxim,24251,17989,74.178384,6262,0.849307,"4219705",
"4231","2707503",Porto Real do Colégio,17673,5812,32.886324,11861,-0.539453,"2707503",
"4232","2707602",Quebrangulo,11254,6539,58.103785,4715,-0.796565,"2707602",
"4233","3534302",Orlândia,36027,35405,98.273517,622,0.009123,"3534302",
"4234","2202901",Corrente,24352,13980,57.408016,10372,0.678601,"2202901",
"4235","3142700",Montalvânia,15914,9858,61.945457,6056,-0.10459,"3142700",
"4236","4300109",Agudo,16577,6522,39.343669,10055,-0.734574,"4300109",
"4237","3534609",Osvaldo Cruz,28761,26704,92.847954,2057,-0.432979,"3534609",
"4238","3142809",Monte Alegre de Minas,18257,13165,72.109328,5092,0.19796,"3142809",
"4239","2203206",Curimatá,10300,5931,57.582524,4369,1.134374,"2203206",
"4240","2708006",Santana do Ipanema,42202,25391,60.165395,16811,0.245096,"2708006",
"4241","3142908",Monte Azul,22407,11823,52.764761,10584,-0.87693,"3142908",
"4242","2708105",Santana do Mundaú,11586,6192,53.443811,5394,0.064282,"2708105",
"4243","3143005",Monte Belo,12481,8531,68.351895,3950,-0.734514,"3143005",
"4244","3143104",Monte Carmelo,44128,38452,87.137418,5676,0.074356,"3143104",
"4245","2708303",São José da Laje,22205,14197,63.93605,8008,0.751665,"2708303",
"4246","3534906",Pacaembu,10959,9571,87.334611,1388,-1.882156,"3534906",
"4247","2708402",São José da Tapera,30059,10951,36.431684,19108,1.246622,"2708402",
"4248","3535002",Palestina,10292,8649,84.036145,1643,1.774016,"3535002",
"4249","3143203",Monte Santo de Minas,19975,15745,78.823529,4230,-0.854692,"3143203",
"4250","2708501",São Luís do Quitunde,31465,19464,61.859209,12001,0.90448,"2708501",
"4251","3535101",Palmares Paulista,10473,10201,97.402845,272,3.136375,"3535101",
"4252","3143401",Monte Sião,19064,14097,73.945657,4967,0.668725,"3143401",
"4253","3535309",Palmital,21222,19197,90.458015,2025,0.355722,"3535309",
"4254","2203453",Dom Inocêncio,10266,1985,19.335671,8281,2.046013,"2203453",
"4255","2708808",São Sebastião,30890,11365,36.791842,19525,0.844545,"2708808",
"4256","3535408",Panorama,13896,13349,96.063615,547,0.25654,"3535408",
"4257","2203503",Elesbão Veloso,14151,9632,68.065861,4519,-0.83079,"2203503",
"4258","3535507",Paraguaçu Paulista,40831,37868,92.743259,2963,0.431758,"3535507",
"4259","2708956",Senador Rui Palmeira,12598,4056,32.195587,8542,0.722353,"2708956",
"4260","3535606",Paraibuna,16385,5023,30.656088,11362,-0.532525,"3535606",
"4261","2203701",Esperantina,36109,21841,60.486305,14268,0.82367,"2203701",
"4262","2709103",Taquarana,18093,4103,22.677279,13990,0.855201,"2709103",
"4263","4300802",Antônio Prado,13582,9497,69.923428,4085,0.718623,"4300802",
"4264","3535804",Paranapanema,16618,13250,79.73282,3368,0.99061,"3535804",
"4265","2709152",Teotônio Vilela,40153,32882,81.891764,7271,1.221697,"2709152",
"4266","3144003",Mutum,26194,13156,50.225242,13038,-0.269222,"3144003",
"4267","2709202",Traipu,24557,7838,31.91758,16719,0.667872,"2709202",
"4268","3536000",Parapuã,10950,8955,81.780822,1995,-0.199315,"3536000",
"4269","3144102",Muzambinho,19810,14574,73.568905,5236,-0.549486,"3144102",
"4270","2709400",Viçosa,25910,18799,72.554998,7111,-0.193129,"2709400",
"4271","4301008",Arroio do Meio,17937,13843,77.17567,4094,0.810968,"4301008",
"4272","3536208",Pariquera-Açu,18000,12593,69.961111,5407,0.281719,"3536208",
"4273","3144300",Nanuque,40093,37056,92.425112,3037,-0.532222,"3144300",
"4274","2807402",Tobias Barreto,46856,30821,65.778129,16035,1.176682,"2807402",
"4275","2805505",Poço Verde,21031,11484,54.605107,9547,0.740099,"2805505",
"4276","3536307",Patrocínio Paulista,12151,9990,82.215456,2161,0.89535,"3536307",
"4277","2800407",Arauá,11594,4433,38.235294,7161,2.487439,"2800407",
"4278","4301206",Arroio do Tigre,12621,5854,46.383012,6767,0.467023,"4301206",
"4279","2204303",Fronteiras,11049,6726,60.874287,4323,1.417895,"2204303",
"4280","2801702",Cristinápolis,15813,7850,49.642699,7963,1.479598,"2801702",
"4281","4301305",Arroio Grande,18296,15718,85.909488,2578,-0.651081,"4301305",
"4282","4301404",Arvorezinha,10134,5824,57.469903,4310,-0.179149,"4301404",
"4283","2204402",Gilbués,10311,4999,48.482203,5312,0.114129,"2204402",
"4284","3144607",Nepomuceno,24249,18562,76.547486,5687,-0.333087,"3144607",
"4285","2802809",Indiaroba,16609,5247,31.591306,11362,3.390066,"2802809",
"4286","3144656",Ninheira,10389,2678,25.777264,7711,1.507387,"3144656",
"4287","2803005",Itabaianinha,37252,17970,48.239021,19282,0.709211,"2803005",
"4288","3536703",Pederneiras,39733,36981,93.073767,2752,1.174723,"3536703",
"4289","3144706",Nova Era,17656,15322,86.780698,2334,-0.079043,"3144706",
"4290","2806305",Santa Luzia do Itanhy,12906,2827,21.904541,10079,-1.103068,"2806305",
"4291","4301636",Balneário Pinhal,10438,9984,95.650508,454,4.931613,"4301636",
"4292","2807501",Tomar do Geru,12834,4535,35.335827,8299,-0.006677,"2807501",
"4293","3537008",Pedregulho,15042,10776,71.63941,4266,0.04567,"3537008",
"4294","2204709",Inhuma,14949,6925,46.324169,8024,0.510043,"2204709",
"4295","2807600",Umbaúba,20520,12085,58.893762,8435,0.943867,"2807600",
"4296","3145000",Nova Ponte,11486,9816,85.460561,1670,2.761434,"3145000",
"4297","2800506",Areia Branca,15492,6997,45.165247,8495,0.631648,"2800506",
"4298","2800670",Boquim,24397,14934,61.212444,9463,0.122983,"2800670",
"4299","3145109",Nova Resende,14088,7992,56.729131,6096,0.2055,"3145109",
"4300","2205003",Itainópolis,11075,2606,23.530474,8469,0.928759,"2205003",
"4301","2803203",Itaporanga d'Ajuda,27990,9252,33.054662,18738,1.350104,"2803203",
"4302","2205102",Itaueira,10511,5272,50.156978,5239,0.224905,"2205102",
"4303","3537404",Pereira Barreto,24139,22628,93.74042,1511,-0.515331,"3537404",
"4304","3145307",Novo Cruzeiro,30222,9259,30.636622,20963,-0.108718,"3145307",
"4305","2805802",Riachão do Dantas,18980,4393,23.145416,14587,-0.165986,"2805802",
"4306","4301909",Barra do Ribeiro,11386,8834,77.58651,2552,-0.562999,"4301909",
"4307","2205201",Jaicós,16782,7789,46.412823,8993,0.811413,"2205201",
"4308","3145356",Novo Oriente de Minas,10278,4159,40.465071,6119,0.429835,"3145356",
"4309","2806206",Salgado,18540,5563,30.005394,12977,-0.256253,"2806206",
"4310","2806800",São Domingos,10077,4795,47.583606,5282,1.215204,"2806800",
"4311","2801009",Campo do Brito,16068,7536,46.900672,8532,0.820208,"2801009",
"4312","4302006",Barros Cassal,11388,3528,30.979979,7860,0.051539,"4302006",
"4313","3537800",Piedade,47765,21401,44.804773,26364,-0.688284,"3537800",
"4314","2801405",Carira,18851,10185,54.028964,8666,0.847202,"2801405",
"4315","3537909",Pilar do Sul,26231,20347,77.568526,5884,1.309313,"3537909",
"4316","2802304",Frei Paulo,12572,7047,56.053134,5525,0.699838,"2802304",
"4317","3145604",Oliveira,37645,33528,89.063621,4117,0.150802,"3145604",
"4318","2205409",Joaquim Pires,13774,4095,29.729926,9679,0.745685,"2205409",
"4319","3538105",Pindorama,14212,13375,94.110611,837,1.160795,"3538105",
"4320","3538204",Pinhalzinho,11776,5836,49.558424,5940,0.996963,"3538204",
"4321","2205508",José de Freitas,35087,19976,56.932767,15111,0.942059,"2205508",
"4322","2803906",Malhador,11705,5321,45.459205,6384,0.276419,"2803906",
"4323","2804102",Moita Bonita,10857,4235,39.007092,6622,0.130948,"2804102",
"4324","4302303",Bom Jesus,11802,8814,74.682257,2988,-0.254014,"4302303",
"4325","3538501",Piquete,14402,13536,93.986946,866,-0.767445,"3538501",
"4326","4302352",Bom Princípio,10889,8193,75.241069,2696,1.977777,"4302352",
"4327","3145901",Ouro Branco,33385,29500,88.363037,3885,1.355149,"3145901",
"4328","3146008",Ouro Fino,30903,21914,70.912209,8989,0.706981,"3146008",
"4329","4302402",Bom Retiro do Sul,11101,8678,78.173138,2423,0.409419,"4302402",
"4330","3538808",Piraju,28113,25145,89.442607,2968,0.110246,"3538808",
"4331","2806008",Ribeirópolis,15573,10595,68.034419,4978,0.123532,"2806008",
"4332","3538907",Pirajuí,18332,16415,89.542876,1917,-1.303189,"3538907",
"4333","3539004",Pirangi,10251,9188,89.63028,1063,0.300413,"3539004",
"4334","2807105",Simão Dias,36954,18683,50.55745,18271,0.054627,"2807105",
"4335","3146305",Padre Paraíso,18044,11171,61.909776,6873,0.458791,"3146305",
"4336","2804201",Monte Alegre de Sergipe,13189,7505,56.90348,5684,1.867209,"2804201",
"4337","3539202",Pirapozinho,23605,22443,95.077314,1162,0.942989,"3539202",
"4338","2804508",Nossa Senhora da Glória,29255,18647,63.739532,10608,1.20076,"2804508",
"4339","4302709",Butiá,19675,18443,93.738247,1232,-0.461151,"4302709",
"4340","2801207",Canindé de São Francisco,21625,11916,55.10289,9709,2.857776,"2801207",
"4341","4302808",Caçapava do Sul,32451,18921,58.30637,13530,-0.929431,"4302808",
"4342","3539400",Piratininga,11158,9558,85.660513,1600,0.757329,"3539400",
"4343","2205706",Luís Correia,26058,11120,42.674035,14938,1.030769,"2205706",
"4344","2805406",Poço Redondo,28904,7247,25.072654,21657,1.511853,"2805406",
"4345","4302907",Cacequi,13568,11842,87.278892,1726,-1.711716,"4302907",
"4346","3539509",Pitangueiras,33240,31786,95.625752,1454,0.92925,"3539509",
"4347","2205805",Luzilândia,24302,13274,54.621019,11028,0.15378,"2205805",
"4348","3146909",Papagaios,14253,12025,84.368203,2228,1.925172,"3146909",
"4349","3540002",Pompéia,19035,17932,94.205411,1103,0.665814,"3540002",
"4350","3147204",Paraguaçu,19529,15749,80.64417,3780,0.436936,"3147204",
"4351","2206100",Matias Olímpio,10430,4191,40.182167,6239,1.001853,"2206100",
"4352","2806602",Santo Amaro das Brotas,11617,8676,74.683653,2941,1.222172,"2806602",
"4353","3540200",Pontal,35506,34821,98.070749,685,2.59297,"3540200",
"4354","3147303",Paraisópolis,17938,15084,84.089642,2854,0.355413,"3147303",
"4355","2206209",Miguel Alves,32112,10398,32.380419,21714,1.049446,"2206209",
"4356","3147402",Paraopeba,22152,19252,86.908631,2900,1.196047,"3147402",
"4357","2801306",Capela,27767,16473,59.325818,11294,0.659659,"2801306",
"4358","2801504",Carmópolis,11842,9696,81.878061,2146,3.429826,"2801504",
"4359","3147600",Passa Quatro,15225,11632,76.400657,3593,0.35208,"3147600",
"4360","2206407",Monsenhor Gil,10290,5203,50.563654,5087,-0.02635,"2206407",
"4361","2206605",Monte Alegre do Piauí,10320,2754,26.686047,7566,0.125209,"2206605",
"4362","3540705",Porto Ferreira,48676,47135,96.834169,1541,0.369016,"3540705",
"4363","2803302",Japaratuba,15430,7366,47.738172,8064,0.836485,"2803302",
"4364","3540754",Potim,15487,13911,89.823723,1576,1.868144,"3540754",
"4365","2803401",Japoatã,13377,3961,29.610526,9416,0.387179,"2803401",
"4366","4304200",Candelária,29276,14219,48.568794,15057,-0.149879,"4304200",
"4367","3540804",Potirendaba,14300,12814,89.608392,1486,0.660465,"3540804",
"4368","3540903",Pradópolis,15122,13921,92.057929,1201,2.282714,"3540903",
"4369","2804607",Nossa Senhora das Dores,23739,15234,64.17288,8505,0.965376,"2804607",
"4370","4304408",Canela,38030,34680,91.191165,3350,1.774205,"4304408",
"4371","2804904",Pacatuba,12274,2609,21.256314,9665,0.889801,"2804904",
"4372","3541208",Presidente Bernardes,13633,10544,77.341744,3089,-1.034127,"3541208",
"4373","4304630",Capão da Canoa,37294,37090,99.452995,204,2.915571,"4304630",
"4374","3148608",Peçanha,17050,8374,49.11437,8676,-0.110943,"3148608",
"4375","2207009",Oeiras,34981,20660,59.060633,14321,0.445204,"2207009",
"4376","4304663",Capão do Leão,23614,21682,91.818413,1932,-0.062759,"4304663",
"4377","3541307",Presidente Epitácio,39120,36563,93.463701,2557,-0.064833,"3541307",
"4378","3148707",Pedra Azul,24751,21959,88.719648,2792,0.677718,"3148707",
"4379","3541505",Presidente Venceslau,35674,34045,95.433649,1629,-0.652582,"3541505",
"4380","2800209",Aquidabã,19145,10446,54.562549,8699,0.612425,"2800209",
"4381","3541604",Promissão,33680,29115,86.445962,4565,1.142703,"3541604",
"4382","3541703",Quatá,11837,11094,93.723072,743,0.221602,"3541703",
"4383","3149101",Pedralva,11110,5182,46.642664,5928,-1.105427,"3149101",
"4384","2207504",Palmeirais,13673,5070,37.080377,8603,1.696585,"2207504",
"4385","2802403",Gararu,11594,2789,24.055546,8805,0.287917,"2802403",
"4386","4304804",Carlos Barbosa,23883,18731,78.428171,5152,2.192484,"4304804",
"4387","3149150",Pedras de Maria da Cruz,10798,6130,56.769772,4668,2.847993,"3149150",
"4388","3541901",Queluz,10211,9246,90.549408,965,1.640066,"3541901",
"4389","2207603",Parnaguá,10138,5090,50.207141,5048,1.170357,"2207603",
"4390","2805604",Porto da Folha,26486,9486,35.815148,17000,0.451402,"2805604",
"4391","3542206",Rancharia,28154,24978,88.719187,3176,-0.309709,"3542206",
"4392","2805703",Propriá,27549,23489,85.262623,4060,0.085334,"2805703",
"4393","2207801",Paulistana,16890,9781,57.910006,7109,0.309124,"2207801",
"4394","3542404",Regente Feijó,17009,15643,91.968958,1366,0.009242,"3542404",
"4395","3149804",Perdizes,13661,8715,63.794744,4946,1.435289,"3149804",
"4396","2207900",Pedro II,36491,21586,59.154312,14905,0.114049,"2207900",
"4397","3149903",Perdões,19319,17025,88.125679,2294,0.438706,"3149903",
"4398","2804409",Neópolis,18857,10448,55.40648,8409,0.201618,"2804409",
"4399","4305207",Cerro Largo,12324,9391,76.200909,2933,-0.389151,"4305207",
"4400","3542909",Ribeirão Bonito,11325,10480,92.538631,845,0.100052,"3542909",
"4401","2208106",Pimenteiras,11691,4605,39.389274,7086,0.479514,"2208106",
"4402","3543006",Ribeirão Branco,18818,9727,51.689871,9091,-1.708782,"3543006",
"4403","2208205",Pio IX,16923,5014,29.628316,11909,0.357929,"2208205",
"4404","4305355",Charqueadas,29998,29374,97.919861,624,0.017633,"4305355",
"4405","2208304",Piracuruca,25562,17570,68.734841,7992,0.44137,"2208304",
"4406","2900207",Abaré,17306,8305,47.989137,9001,3.450484,"2900207",
"4407","2900306",Acajutiba,14585,12292,84.278368,2293,0.260292,"2900306",
"4408","2208502",Porto,11429,7329,64.126345,4100,1.118356,"2208502",
"4409","2900355",Adustina,14779,4973,33.649097,9806,0.469784,"2900355",
"4410","2900405",Água Fria,14569,5194,35.65104,9375,-0.145255,"2900405",
"4411","2900504",Érico Cardoso,10588,1536,14.506989,9052,-1.958154,"2900504",
"4412","4305454",Cidreira,10849,10413,95.981196,436,2.899029,"4305454",
"4413","2208809",Regeneração,17595,13521,76.845695,4074,0.101085,"2208809",
"4414","2900801",Alcobaça,19600,10366,52.887755,9234,-0.913227,"2900801",
"4415","3543709",Rincão,10393,8740,84.095064,1653,0.086898,"3543709",
"4416","3150802",Piranga,17088,5648,33.052434,11440,0.065379,"3150802",
"4417","2901007",Amargosa,33455,23463,70.133014,9992,1.044506,"2901007",
"4418","2901106",Amélia Rodrigues,22060,18790,85.176791,3270,-1.275448,"2901106",
"4419","3544004",Rio das Pedras,26324,25071,95.240085,1253,1.638072,"3544004",
"4420","3151107",Pirapetinga,10199,8889,87.155603,1310,0.233277,"3151107",
"4421","2901155",América Dourada,16029,10464,65.281677,5565,0.062543,"2901155",
"4422","2901205",Anagé,25634,4701,18.338925,20933,-2.705599,"2901205",
"4423","3151305",Piraúba,10644,8432,79.218339,2212,-0.648543,"3151305",
"4424","2901304",Andaraí,14051,7644,54.401822,6407,0.170953,"2901304",
"4425","3544251",Rosana,19742,15467,78.345659,4275,-2.883356,"3544251",
"4426","3151404",Pitangui,24410,20497,83.969685,3913,1.320027,"3151404",
"4427","2901353",Andorinha,14116,5601,39.678379,8515,-1.573969,"2901353",
"4428","3151503",Piumhi,30752,27341,88.908039,3411,0.949769,"3151503",
"4429","2901403",Angical,14672,6890,46.960196,7782,-0.028205,"2901403",
"4430","4306007",Crissiumal,14637,5932,40.52743,8705,-0.519023,"4306007",
"4431","3151602",Planura,10275,9976,97.090024,299,3.101699,"3151602",
"4432","3151701",Poço Fundo,15258,9076,59.48355,6182,0.103417,"3151701",
"4433","2901601",Antas,16219,6621,40.822492,9598,2.062709,"2901601",
"4434","2901700",Antônio Cardoso,12067,2581,21.388912,9486,0.540695,"2901700",
"4435","2901809",Antônio Gonçalves,10562,5250,49.706495,5312,1.199836,"2901809",
"4436","4306205",Cruzeiro do Sul,12105,7036,58.124742,5069,0.531571,"4306205",
"4437","3152006",Pompéu,28123,24880,88.468513,3243,1.078257,"3152006",
"4438","2901908",Aporá,17794,7987,44.885917,9807,0.851165,"2901908",
"4439","3545001",Salesópolis,15099,9416,62.361746,5683,0.722467,"3545001",
"4440","2902005",Aracatu,14153,3617,25.556419,10536,-1.282175,"2902005",
"4441","3152170",Ponto dos Volantes,10955,3861,35.244181,7094,0.568217,"3152170",
"4442","2902054",Araças,11637,5887,50.58864,5750,0.803521,"2902054",
"4443","3152204",Porteirinha,36636,18240,49.787095,18396,-0.479644,"3152204",
"4444","3152303",Porto Firme,10331,4817,46.626658,5514,1.244796,"3152303",
"4445","3152402",Poté,14688,8723,59.388617,5965,-0.089161,"3152402",
"4446","2902252",Arataca,10537,4984,47.299991,5553,-0.890678,"2902252",
"4447","4306502",Dom Feliciano,14431,3081,21.349872,11350,1.176007,"4306502",
"4448","2902401",Aurelino Leal,14435,11997,83.110495,2438,-2.43116,"2902401",
"4449","3545605",Santa Adélia,13775,12948,93.99637,827,0.342737,"3545605",
"4450","2902500",Baianópolis,13390,3019,22.546677,10371,1.363425,"2902500",
"4451","4306601",Dom Pedrito,37898,34542,91.144651,3356,-0.912652,"4306601",
"4452","3152808",Prata,24460,18582,75.968929,5878,0.527241,"3152808",
"4453","2902609",Baixa Grande,20907,8118,38.8291,12789,0.322538,"2902609",
"4454","2902658",Banzaê,10850,3625,33.410138,7225,-0.396532,"2902658",
"4455","3546009",Santa Branca,13241,11884,89.751529,1357,0.251742,"3546009",
"4456","2902708",Barra,47386,20942,44.194488,26444,0.998295,"2902708",
"4457","2210003",São João do Piauí,18675,12074,64.65328,6601,0.79338,"2210003",
"4458","2902807",Barra da Estiva,20664,9082,43.950832,11582,-2.369031,"2902807",
"4459","2902906",Barra do Choça,32415,21198,65.39565,11217,-3.239259,"2902906",
"4460","4306809",Encantado,19457,16902,86.868479,2555,0.70136,"4306809",
"4461","2903003",Barra do Mendes,14019,6288,44.853413,7731,0.423878,"2903003",
"4462","4306908",Encruzilhada do Sul,23959,16015,66.843357,7944,0.034033,"4306908",
"4463","3546306",Santa Cruz das Palmeiras,29842,28755,96.357483,1087,2.239635,"3546306",
"4464","3153400",Presidente Olegário,18154,12276,67.621461,5878,0.297018,"3153400",
"4465","3546405",Santa Cruz do Rio Pardo,41409,37602,90.806346,3807,0.170198,"3546405",
"4466","2903235",Barro Alto,13359,6162,46.126207,7197,1.42651,"2903235",
"4467","3546603",Santa Fé do Sul,27572,26343,95.542579,1229,0.561618,"3546603",
"4468","3546702",Santa Gertrudes,18997,18661,98.2313,336,2.569378,"3546702",
"4469","2903409",Belmonte,21296,11491,53.95849,9805,0.87795,"2903409",
"4470","2210409",São Miguel do Tapuio,19137,7010,36.630611,12127,0.24804,"2210409",
"4471","2903508",Belo Campo,15251,8360,54.816078,6891,-2.069346,"2903508",
"4472","2210508",São Pedro do Piauí,12865,7611,59.160513,5254,0.400545,"2210508",
"4473","3154002",Raul Soares,23740,15003,63.197136,8737,-0.324897,"3154002",
"4474","2903607",Biritinga,13867,3070,22.138891,10797,-0.77291,"2903607",
"4475","2210607",São Raimundo Nonato,30739,19571,63.668304,11168,1.929489,"2210607",
"4476","3154101",Recreio,10147,8997,88.666601,1150,-0.05759,"3154101",
"4477","2903706",Boa Nova,15973,5662,35.447317,10311,-3.531411,"2903706",
"4478","2903805",Boa Vista do Tupim,17552,6079,34.63423,11473,-0.677941,"2903805",
"4479","3154200",Resende Costa,10465,8120,77.591973,2345,0.177349,"3154200",
"4480","3154309",Resplendor,16851,13015,77.235772,3836,-0.104683,"3154309",
"4481","2903953",Bom Jesus da Serra,10264,2405,23.431411,7859,-0.326937,"2903953",
"4482","2904001",Boninal,13199,4203,31.843321,8996,0.825349,"2904001",
"4483","2210706",Simões,13694,5508,40.221995,8186,0.076387,"2210706",
"4484","4307500",Espumoso,14806,10492,70.863164,4314,-1.264119,"4307500",
"4485","3547502",Santa Rita do Passa Quatro,26108,23499,90.006894,2609,-0.016405,"3547502",
"4486","2210805",Simplício Mendes,11415,6883,60.297854,4532,0.574914,"2210805",
"4487","2904050",Bonito,13589,5873,43.21878,7716,0.743872,"2904050",
"4488","3547601",Santa Rosa de Viterbo,22630,21615,95.514803,1015,0.77803,"3547601",
"4489","2904100",Boquira,21824,7233,33.142412,14591,-0.192915,"2904100",
"4490","2904209",Botuporã,11008,3706,33.666424,7302,-0.649822,"2904209",
"4491","3547700",Santo Anastácio,20454,19018,92.979368,1436,-0.204356,"3547700",
"4492","2904308",Brejões,12597,4375,34.730491,8222,-2.778746,"2904308",
"4493","4307807",Estrela,28921,24398,84.360845,4523,0.774246,"4307807",
"4494","2904506",Brotas de Macaúbas,10901,3115,28.57536,7786,-2.487476,"2904506",
"4495","3548005",Santo Antônio de Posse,19767,15850,80.184145,3917,1.247385,"3548005",
"4496","2211100",União,41584,19916,47.893421,21668,0.628013,"2211100",
"4497","2211209",Uruçuí,18952,13149,69.38054,5803,1.555535,"2211209",
"4498","2904704",Buerarema,19814,16929,85.439588,2885,0.512142,"2904704",
"4499","2904753",Buritirama,18630,7168,38.475577,11462,0.655615,"2904753",
"4500","2211308",Valença do Piauí,19697,13905,70.594507,5792,-0.137048,"2211308",
"4501","2904803",Caatiba,10360,5608,54.131274,4752,-5.6,"2904803",
"4502","3155504",Rio Paranaíba,10744,6554,61.001489,4190,-1.001118,"3155504",
"4503","2904852",Cabaceiras do Paraguaçu,17454,4056,23.238226,13398,1.666609,"2904852",
"4504","3155603",Rio Pardo de Minas,28566,11183,39.147938,17383,0.682905,"3155603",
"4505","2904902",Cachoeira,31352,16304,52.003062,15048,0.433928,"2904902",
"4506","4308102",Feliz,11647,8799,75.547351,2848,0.412721,"4308102",
"4507","3155702",Rio Piracicaba,14260,11350,79.593268,2910,0.122821,"3155702",
"4508","2905008",Caculé,21805,12308,56.445769,9497,0.999232,"2905008",
"4509","4308201",Flores da Cunha,25223,16338,64.774214,8885,0.907088,"4308201",
"4510","3548609",São Bento do Sapucaí,10435,5014,48.049832,5421,0.110004,"3548609",
"4511","3155801",Rio Pomba,16621,13929,83.803622,2692,0.22724,"3155801",
"4512","2905107",Caém,10345,3558,34.393427,6787,-2.736888,"2905107",
"4513","2905156",Caetanos,12107,2694,22.25159,9413,-1.093897,"2905156",
"4514","2300101",Abaiara,10156,4134,40.705002,6022,2.775244,"2300101",
"4515","4308300",Fontoura Xavier,11036,3818,34.595868,7218,-0.553232,"4308300",
"4516","3156007",Rio Vermelho,14761,5659,38.337511,9102,-0.138592,"3156007",
"4517","2905206",Caetité,46010,25743,55.95088,20267,0.288963,"2905206",
"4518","2300150",Acarapé,14635,7774,53.119235,6861,1.788633,"2300150",
"4519","2905305",Cafarnaum,17317,9777,56.458971,7540,1.083243,"2905305",
"4520","2300309",Acopiara,48571,24401,50.237796,24170,0.429038,"2300309",
"4521","2905404",Cairu,13402,7616,56.827339,5786,2.325394,"2905404",
"4522","4308508",Frederico Westphalen,27080,21333,78.777696,5747,0.170496,"4308508",
"4523","2300408",Aiuaba,15556,3620,23.270764,11936,1.057172,"2300408",
"4524","2905503",Caldeirão Grande,13053,4331,33.180112,8722,1.959571,"2905503",
"4525","4308607",Garibaldi,28707,25508,88.856376,3199,0.185495,"4308607",
"4526","2300507",Alcântaras,10232,3070,30.003909,7162,0.993306,"2300507",
"4527","2905602",Camacan,30187,23754,78.689502,6433,-0.404159,"2905602",
"4528","2905800",Camamu,32048,13369,41.715552,18679,-0.699047,"2905800",
"4529","2300705",Alto Santo,18558,7509,40.462334,11049,2.706303,"2300705",
"4530","3549409",São Joaquim da Barra,43486,42824,98.477671,662,0.639916,"3549409",
"4531","2905909",Campo Alegre de Lourdes,26910,5840,21.70197,21070,-0.364639,"2905909",
"4532","2300754",Amontada,37188,14104,37.926213,23084,2.018644,"2300754",
"4533","4308904",Getúlio Vargas,15790,13227,83.768208,2563,-0.634108,"4308904",
"4534","2906105",Canápolis,10498,3015,28.719756,7483,1.071928,"2906105",
"4535","3156809",Sabinópolis,15839,10056,63.488857,5783,-0.381929,"3156809",
"4536","2300903",Apuiarés,13614,6021,44.226532,7593,1.180848,"2300903",
"4537","4309001",Giruá,16976,12412,73.114986,4564,-1.409118,"4309001",
"4538","3156908",Sacramento,22057,17422,78.986263,4635,0.477249,"3156908",
"4539","2906204",Canarana,24286,11365,46.796508,12921,1.644838,"2906204",
"4540","3157005",Salinas,37269,28221,75.72245,9048,0.212229,"3157005",
"4541","2906303",Canavieiras,35361,28013,79.220045,7348,0.015766,"2906303",
"4542","4309100",Gramado,31305,27867,89.017729,3438,1.302928,"4309100",
"4543","2301208",Aracoiaba,24367,13147,53.954118,11220,0.178914,"2301208",
"4544","3157203",Santa Bárbara,26016,23321,89.64099,2695,1.050997,"3157203",
"4545","2301257",Ararendá,10616,4833,45.525622,5783,0.846095,"2301257",
"4546","3550001",São Luís do Paraitinga,10471,6493,62.009359,3978,0.057433,"3550001",
"4547","2906600",Candiba,12345,6818,55.228838,5527,0.258393,"2906600",
"4548","2301307",Araripe,21176,12833,60.601624,8343,1.106546,"2301307",
"4549","3550100",São Manuel,37532,35912,95.683683,1620,0.381433,"3550100",
"4550","2906709",Cândido Sales,26657,19145,71.819785,7512,-0.958428,"2906709",
"4551","2301406",Aratuba,12048,3028,25.132802,9020,-0.363422,"2301406",
"4552","3550209",São Miguel Arcanjo,30303,19381,63.957364,10922,-0.231204,"3550209",
"4553","2906808",Cansanção,32670,10632,32.543618,22038,0.320211,"2906808",
"4554","2301604",Assaré,21525,10043,46.657375,11482,0.43419,"2301604",
"4555","2906824",Canudos,14586,7617,52.221308,6969,0.835235,"2906824",
"4556","4309407",Guaporé,21243,19250,90.618086,1993,0.819054,"4309407",
"4557","3550407",São Pedro,29596,25003,84.481011,4593,0.848149,"3550407",
"4558","2906857",Capela do Alto Alegre,12300,5901,47.97561,6399,0.475828,"2906857",
"4559","2301703",Aurora,24370,10790,44.275749,13580,-0.481251,"2301703",
"4560","2906873",Capim Grosso,25724,19770,76.854299,5954,1.051364,"2906873",
"4561","2906899",Caraíbas,10493,1935,18.440865,8558,-6.788663,"2906899",
"4562","2301851",Banabuiú,17410,8424,48.385985,8986,1.058442,"2301851",
"4563","2100832",Apicum-Açu,13127,7586,57.789289,5541,2.426342,"2100832",
"4564","5103254",Colniza,27659,15707,56.788026,11952,0,"5103254",
"4565","2703759",Jequiá da Praia,11424,2538,22.216387,8886,8.602988,"2703759",
"4566","2903276",Barrocas,13160,4193,31.861702,8967,0,"2903276",
"4567","2919553",Luís Eduardo magalhães,43794,40220,91.839065,3574,0,"2919553",
"503","2922904",Nova Soure,25472,11002,43.192525,14470,0.613183,"2922904",./0.png
"2792","2922904",Nova Soure,25472,11002,43.192525,14470,0.613183,"2922904",./0.png
